\database\database_area.msbt
areaName_area01	{r[きょうわこく]}共和国{/r}
areaName_area02	{r[かいがん]}海岸{/r}エリア
areaName_area03	{r[かざん]}火山{/r}エリア
areaName_area04	{r[ていこくにし]}帝国西{/r}エリア
areaName_area04Sub	{r[ていこくにし]}帝国西{/r}エリア{r[おくち]}奥地{/r}
areaName_area04Camp	{r[やえい]}野営{/r}キャンプ
areaName_area05	{r[ゆきやま]}雪山{/r}エリア
areaName_area06	{r[ていこくほんど]}帝国本土{/r}エリア
areaName_area06Sub	{r[ていこくみなみ]}帝国南{/r}エリア
areaName_area07	{r[ていこくきゅうでん]}帝国宮殿{/r}
areaName_area08	{r[なぞ]}謎{/r}の{r[こじま]}小島{/r}
areaName_area50	スシロー{r[じま]}島{/r}エリア
areaName_home	{r[ちんじゅ]}鎮守{/r}の{r[もり]}森{/r}のかくれ{r[さと]}里{/r}
areaText_area01	{r[あたた]}暖{/r}かな{r[きこう]}気候{/r}の{r[しぜん]}自然{/r}ゆたかな{r[くに]}国{/r}。\n{r[せかい]}世界{/r}スシ{r[たいせん]}大戦{/r}で{r[ていこく]}帝国{/r}に{r[はいぼく]}敗北{/r}。\n{r[め]}目{/r}ぼしいスシをすべてうばわれ、\nスシ{r[ふもう]}不毛{/r}の{r[ち]}地{/r}と{r[い]}言{/r}われていたが…
areaText_area02	まぶしい{r[たいよう]}太陽{/r}が{r[て]}照{/r}りつける{r[ちいき]}地域{/r}。\n{r[ていこく]}帝国{/r}の{r[しはいか]}支配下{/r}にある。\nかつてリゾートだった{r[しま]}島{/r}・コドー\nも{r[いま]}今{/r}や{r[ていこくぐん]}帝国軍{/r}の{r[とりで]}砦{/r}となっている。
areaText_area03	{r[も]}燃{/r}えたぎる{r[かつかざん]}活火山{/r}・{r[ひゃっきかざん]}百鬼火山{/r}の\nある{r[ちいき]}地域{/r}。{r[ていこく]}帝国{/r}の{r[しはいか]}支配下{/r}にある。\n{r[みなみ]}南{/r}には{r[おんせん]}温泉{/r}、{r[きた]}北{/r}には{r[ほうせきこうざん]}宝石鉱山{/r}が\nあり、{r[いがい]}意外{/r}にもにぎわっている。
areaText_area04	かつて{r[ゆうぼくみん]}遊牧民{/r}がくらしていた{r[かんそう]}乾燥{/r}\n{r[ちたい]}地帯{/r}だが、{r[いま]}今{/r}は{r[ゆた]}豊{/r}かな{r[のうち]}農地{/r}に。\n{r[ていこくほんど]}帝国本土{/r}へ{r[つづ]}続{/r}く{r[はし]}橋{/r}は、{r[なんこうふらく]}難攻不落{/r}の\n{r[ようさい]}要塞{/r}ナバによって{r[まも]}守{/r}られている。
areaText_area04Sub	{r[ていこく]}帝国{/r}の{r[しはい]}支配{/r}の{r[め]}目{/r}がゆきとどき\nにくい{r[にし]}西{/r}の{r[おくち]}奥地{/r}には、{r[きょうわこく]}共和国{/r}\nだったころの{r[ぶんか]}文化{/r}が{r[いま]}今{/r}も{r[のこ]}残{/r}り、\nかくれ{r[じんじゃ]}神社{/r}も{r[そんざい]}存在{/r}するという。
areaText_area04Camp	スシ{r[かいほうせんせん]}解放戦線{/r}の{r[ていこくせいぶこうりゃく]}帝国西部攻略{/r}の\n{r[きょてん]}拠点{/r}となっているキャンプ。\n{r[さくせん]}作戦{/r}は{r[じゅんちょう]}順調{/r}に{r[すす]}進{/r}んでいるかの\nように{r[み]}見{/r}えたのだが…。
areaText_area05	{r[いちねん]}一年{/r}を{r[とお]}通{/r}して{r[ゆきぶか]}雪深{/r}い{r[やま]}山{/r}、{r[りっかさん]}六花山{/r}を\n{r[ちゅうしん]}中心{/r}とした{r[ちいき]}地域{/r}。{r[やま]}山{/r}を{r[こ]}越{/r}えた{r[さき]}先{/r}の\n{r[こじま]}小島{/r}には、{r[ていこくぐん]}帝国軍{/r}の{r[ひみつしせつ]}秘密施設{/r}が\nあると{r[い]}言{/r}われている…。
areaText_area06	{r[しんようじゅ]}針葉樹{/r}の{r[もり]}森{/r}を{r[き]}切{/r}り{r[ひら]}開{/r}いて{r[つく]}作{/r}られた\n{r[こうだい]}広大{/r}な{r[こくど]}国土{/r}は、テクノロジーと\nきびしい{r[とうせい]}統制{/r}で{r[はってん]}発展{/r}をとげた。\nその{r[とうぶ]}東部{/r}には{r[しゅと]}首都{/r}と{r[きゅうでん]}宮殿{/r}がある。
areaText_area06Sub	{r[ゆた]}豊{/r}かなスシ{r[しげん]}資源{/r}を{r[もと]}求{/r}めた{r[ていこく]}帝国{/r}が\n{r[なんしん]}南進{/r}して{r[しはいか]}支配下{/r}に{r[い]}入{/r}れた{r[とち]}土地{/r}。\n{r[なんたん]}南端{/r}にある{r[ぐんじしせつ]}軍事施設{/r}では、{r[ひみつ]}秘密{/r}の\n{r[けんきゅう]}研究{/r}が{r[おこな]}行{/r}われているという…。
areaText_area07	{r[ていこく]}帝国{/r}を{r[す]}統{/r}べる{r[こうてい]}皇帝{/r}の{r[きょじょう]}居城{/r}であり、\n{r[ていこくぐん]}帝国軍{/r}の{r[そうしれいぶ]}総司令部{/r}がおかれている\n{r[しっこく]}漆黒{/r}の{r[しろ]}城{/r}。{r[こらい]}古来{/r}より{r[つづ]}続{/r}く{r[こうていちょくぞく]}皇帝直属{/r}\nの{r[しんえいたい]}親衛隊{/r}によって{r[まも]}守{/r}られている。
areaText_area08	{r[ちんじゅ]}鎮守{/r}の{r[もり]}森{/r}と{r[どうよう]}同様{/r}、スシ{r[しんこう]}信仰{/r}の\n{r[いせき]}遺跡{/r}が{r[のこ]}残{/r}る{r[ちい]}小{/r}さな{r[しま]}島{/r}。\n{r[むじん]}無人{/r}の{r[しま]}島{/r}のはずが、{r[さいきん]}最近{/r}ここで\n{r[なぞ]}謎{/r}の{r[ばくはつ]}爆発{/r}があったらしい…。
areaText_area50	{r[とつじょ]}突如{/r}、{r[うみ]}海{/r}のかなたに{r[あらわ]}現{/r}れた{r[しまじま]}島々{/r}…。\nしかし{r[ていこく]}帝国{/r}はそれをいち{r[はや]}早{/r}く{r[せんきょ]}占拠{/r}。\nその{r[じょうほう]}情報{/r}をキャッチしたムサシは、\n{r[しま]}島{/r}への{r[じょうりく]}上陸{/r}を{r[は]}果{/r}たすが…。
\database\database_cmn.msbt
SushiName_None	なし
SushiName_Kappa	カッパ{r[ま]}巻{/r}き
SushiFavPowerName_Kappa	カリウム
SushiFavPowerName_Kappa_lc	カリウム
SushiName_Tamago	たまご
SushiFavPowerName_Tamago	ビオチン
SushiFavPowerName_Tamago_lc	ビオチン
SushiName_Inari	いなりずし
SushiFavPowerName_Inari	モリブデン
SushiFavPowerName_Inari_lc	モリブデン
SushiName_CornWarship	コーン{r[ぐんかん]}軍艦{/r}
SushiFavPowerName_CornWarship	リノールサン
SushiFavPowerName_CornWarship_lc	リノールサン
SushiName_Aji	アジ
SushiFavPowerName_Aji	イノシンサン
SushiFavPowerName_Aji_lc	イノシンサン
SushiName_Ika	いか
SushiFavPowerName_Ika	リジン
SushiFavPowerName_Ika_lc	リジン
SushiName_Salmon	サーモン
SushiFavPowerName_Salmon	アスタキサンチン
SushiFavPowerName_Salmon_lc	アスタキサンチン
SushiName_EbimayoWarship	えびマヨ{r[ぐんかん]}軍艦{/r}
SushiFavPowerName_EbimayoWarship	ナトリウム
SushiFavPowerName_EbimayoWarship_lc	ナトリウム
SushiName_Ebi	えび
SushiFavPowerName_Ebi	アルギニン
SushiFavPowerName_Ebi_lc	アルギニン
SushiName_Tako	たこ
SushiFavPowerName_Tako	コバラミン
SushiFavPowerName_Tako_lc	コバラミン
SushiName_NegitoroWarship	ねぎとろ{r[ぐんかん]}軍艦{/r}
SushiFavPowerName_NegitoroWarship	アスコルビンサン
SushiFavPowerName_NegitoroWarship_lc	アスコルビンサン
SushiName_Katuo	かつお
SushiFavPowerName_Katuo	テツブン
SushiFavPowerName_Katuo_lc	テツブン
SushiName_SalmonRoast	あぶりサーモン
SushiFavPowerName_SalmonRoast	アスタキサンチンZ
SushiFavPowerName_SalmonRoast_lc	アスタキサンチンZ
SushiName_Buri	ぶり
SushiFavPowerName_Buri	ディーエイチエー
SushiFavPowerName_Buri_lc	ディーエイチエー
SushiName_CaliforniaRoll	カリフォルニアロール
SushiFavPowerName_CaliforniaRoll	ヨード
SushiFavPowerName_CaliforniaRoll_lc	ヨード
SushiName_Bintoro	びんとろ
SushiFavPowerName_Bintoro	ナイアシン
SushiFavPowerName_Bintoro_lc	ナイアシン
SushiName_Engawa	えんがわ
SushiFavPowerName_Engawa	リボフラビン
SushiFavPowerName_Engawa_lc	リボフラビン
SushiName_EbiRoast	あぶりえび
SushiFavPowerName_EbiRoast	アルギニンZ
SushiFavPowerName_EbiRoast_lc	アルギニンZ
SushiName_Hotate	ホタテ
SushiFavPowerName_Hotate	タウリン
SushiFavPowerName_Hotate_lc	タウリン
SushiName_Amaebi	あまえび
SushiFavPowerName_Amaebi	αトコフェロール
SushiFavPowerName_Amaebi_lc	αトコフェロール
SushiName_Maguro	まぐろ
SushiFavPowerName_Maguro	ヒスチジン
SushiFavPowerName_Maguro_lc	ヒスチジン
SushiName_Ebitenroll	えび{r[てん]}天{/r}ロール
SushiFavPowerName_Ebitenroll	セレン
SushiFavPowerName_Ebitenroll_lc	セレン
SushiName_EngawaRoast	あぶりえんがわ
SushiFavPowerName_EngawaRoast	リボフラビンZ
SushiFavPowerName_EngawaRoast_lc	リボフラビンZ
SushiName_Anago	あなご
SushiFavPowerName_Anago	レチノール
SushiFavPowerName_Anago_lc	レチノール
SushiName_ShirasuWarship	{r[なま]}生{/r}しらす{r[ぐんかん]}軍艦{/r}
SushiFavPowerName_ShirasuWarship	カルシウム
SushiFavPowerName_ShirasuWarship_lc	カルシウム
SushiName_Torosalmon	トロサーモン
SushiFavPowerName_Torosalmon	アスタキサンチンX
SushiFavPowerName_Torosalmon_lc	アスタキサンチンX
SushiName_Rainbowroll	レインボーロール
SushiFavPowerName_Rainbowroll	オレインサン
SushiFavPowerName_Rainbowroll_lc	オレインサン
SushiName_HotateRoast	あぶりホタテ
SushiFavPowerName_HotateRoast	タウリンZ
SushiFavPowerName_HotateRoast_lc	タウリンZ
SushiName_Ikura	いくら{r[ぐんかん]}軍艦{/r}
SushiFavPowerName_Ikura	チアミン
SushiFavPowerName_Ikura_lc	チアミン
SushiName_Kinmedai	きんめだい
SushiFavPowerName_Kinmedai	リン
SushiFavPowerName_Kinmedai_lc	リン
SushiName_Tarabagani	かに
SushiFavPowerName_Tarabagani	グルタミンサン
SushiFavPowerName_Tarabagani_lc	グルタミンサン
SushiName_Unagi	うなぎ
SushiFavPowerName_Unagi	アエン
SushiFavPowerName_Unagi_lc	アエン
SushiName_Uni	うに{r[ぐんかん]}軍艦{/r}
SushiFavPowerName_Uni	ヨウサン
SushiFavPowerName_Uni_lc	ヨウサン
SushiName_BotanEbi	ぼたんえび
SushiFavPowerName_BotanEbi	クロム
SushiFavPowerName_BotanEbi_lc	クロム
SushiName_Chuutoro	{r[ちゅう]}中{/r}トロ
SushiFavPowerName_Chuutoro	ピリドキシン
SushiFavPowerName_Chuutoro_lc	ピリドキシン
SushiName_Ootoro	{r[おお]}大{/r}トロ
SushiFavPowerName_Ootoro	イーピーエー
SushiFavPowerName_Ootoro_lc	イーピーエー
SushiName_LegendTorosalmon	{r[でんせつ]}伝説{/r}のトロサーモン
SushiFavPowerName_LegendTorosalmon	パントテンサン
SushiFavPowerName_LegendTorosalmon_lc	パントテンサン
SushiName_Mikan	カットオレンジ
SushiName_Strawberry	いちご
SushiName_PineCut	カットパイン
SushiName_MelonCut	カットメロン
SushiName_KiwiCut	カットキウイ
SushiName_MangoCut	カットマンゴー
SushiName_Melon	{r[こうきゅう]}高級{/r}メロン
SushiName_FruitsAssort	{r[も]}盛{/r}り{r[あ]}合{/r}わせフルーツ
DishColorName00	ミズイロ
DishColorName01	キイロ
DishColorName02	ムラサキ
DishColorName03	ミドリ
DishColorName04	アオ
DishColorName05	アカ
DishColorName06	ギン
DishColorName07	クロ
DishColorName08	キン
EnemyName_Ablicos	{r[しょうぐん]}将軍{/r}アブリコス
EnemyName_001	テイコク{r[へい]}兵{/r}イワノフ
EnemyName_002	{r[たいちょう]}隊長{/r}レオノフ
EnemyName_Kojiro_00	コジロー
EnemyName_004	テイコク{r[へい]}兵{/r}コブリン
EnemyName_005	テイコク{r[へい]}兵{/r}クドリン
EnemyName_006	テイコク{r[へい]}兵{/r}カレリン
EnemyName_007	{r[たいちょう]}隊長{/r}ガガーリン
EnemyName_Ryoma	リョーマ
EnemyName_009	トツゲキ{r[へい]}兵{/r}ボルチン
EnemyName_010	コウサク{r[へい]}兵{/r}ザモチン
EnemyName_011	トクシュ{r[へい]}兵{/r}バフチン
EnemyName_012	{r[たいちょう]}隊長{/r}パカーチン
EnemyName_Kojiro	テイコク{r[へい]}兵{/r}コジロー
EnemyName_014	トツゲキ{r[へい]}兵{/r}ペシコフ
EnemyName_015	コウサク{r[へい]}兵{/r}トンコフ
EnemyName_016	トクシュ{r[へい]}兵{/r}ゴリコフ
EnemyName_017	{r[たいちょう]}隊長{/r}ナボコフ
EnemyName_019	{r[しれいかん]}司令官{/r}ゴーリキー
EnemyName_Yulia	テイコク{r[へい]}兵{/r}ユーリア
EnemyName_021	トツゲキ{r[へい]}兵{/r}ウラノフ
EnemyName_022	コウサク{r[へい]}兵{/r}ミロノフ
EnemyName_023	トクシュ{r[へい]}兵{/r}サガノフ
EnemyName_024	{r[たいちょう]}隊長{/r}アントノフ
EnemyName_026	トツゲキ{r[へい]}兵{/r}コベキン
EnemyName_027	コウサク{r[へい]}兵{/r}パンキン
EnemyName_028	トクシュ{r[へい]}兵{/r}ブリキン
EnemyName_029	{r[たいちょう]}隊長{/r}ポチョムキン
EnemyName_032	トツゲキ{r[へい]}兵{/r}シデンコ
EnemyName_033	コウサク{r[へい]}兵{/r}ゴレンコ
EnemyName_034	トクシュ{r[へい]}兵{/r}リセンコ
EnemyName_035	{r[たいちょう]}隊長{/r}エロシェンコ
EnemyName_036	？？？
EnemyName_Charao	チャラオ
EnemyName_037	トツゲキ{r[へい]}兵{/r}ユスポワ
EnemyName_038	コウサク{r[へい]}兵{/r}ポポワ
EnemyName_039	トクシュ{r[へい]}兵{/r}シレポワ
EnemyName_040	{r[たいちょう]}隊長{/r}シャラポワ
EnemyName_042	トツゲキ{r[へい]}兵{/r}カザコフ
EnemyName_043	コウサク{r[へい]}兵{/r}ルイコフ
EnemyName_044	トクシュ{r[へい]}兵{/r}マルコフ
EnemyName_045	{r[たいちょう]}隊長{/r}カリンニコフ
EnemyName_047	トツゲキ{r[へい]}兵{/r}シャモワ
EnemyName_048	コウサク{r[へい]}兵{/r}クリモワ
EnemyName_049	トクシュ{r[へい]}兵{/r}ソモワ
EnemyName_050	{r[たいちょう]}隊長{/r}マクシモワ
EnemyName_Bambooque	{r[しょうぐん]}将軍{/r}バンブーク
EnemyName_053	トツゲキ{r[へい]}兵{/r}アラポフ
EnemyName_054	コウサク{r[へい]}兵{/r}カルポフ
EnemyName_055	トクシュ{r[へい]}兵{/r}トレポフ
EnemyName_056	{r[たいちょう]}隊長{/r}アンドロポフ
EnemyName_058	トツゲキ{r[へい]}兵{/r}ジン
EnemyName_059	コウサク{r[へい]}兵{/r}ダン
EnemyName_060	トクシュ{r[へい]}兵{/r}バン
EnemyName_061	{r[たいちょう]}隊長{/r}カシン
EnemyName_062	{r[でんじほう]}電磁砲{/r}トカレフ
EnemyName_063	トツゲキ{r[へい]}兵{/r}トルホフ
EnemyName_064	コウサク{r[へい]}兵{/r}オブホフ
EnemyName_065	トクシュ{r[へい]}兵{/r}スーホフ
EnemyName_066	{r[たいちょう]}隊長{/r}チェーホフ
EnemyName_067	{r[でんじほう]}電磁砲{/r}マカロフ
EnemyName_068	トツゲキ{r[へい]}兵{/r}ヤマモト
EnemyName_069	コウサク{r[へい]}兵{/r}アキモト
EnemyName_070	トクシュ{r[へい]}兵{/r}ミヤモト
EnemyName_071	{r[たいちょう]}隊長{/r}サカモト
EnemyName_Grom	{r[げんすい]}元帥{/r}グロム
EnemyName_074	トツゲキ{r[へい]}兵{/r}カリモフ
EnemyName_075	コウサク{r[へい]}兵{/r}アダモフ
EnemyName_076	トクシュ{r[へい]}兵{/r}ソロモフ
EnemyName_077	{r[たいちょう]}隊長{/r}アシモフ
EnemyName_079	トツゲキ{r[へい]}兵{/r}レスコフ
EnemyName_080	コウサク{r[へい]}兵{/r}ユーコフ
EnemyName_081	トクシュ{r[へい]}兵{/r}メンコフ
EnemyName_082	{r[たいちょう]}隊長{/r}マレンコフ
EnemyName_084	トツゲキ{r[へい]}兵{/r}クスミン
EnemyName_085	コウサク{r[へい]}兵{/r}ドレミン
EnemyName_086	トクシュ{r[へい]}兵{/r}テルミン
EnemyName_087	{r[たいちょう]}隊長{/r}リューミン
EnemyName_089	トツゲキ{r[へい]}兵{/r}アロノフ
EnemyName_090	コウサク{r[へい]}兵{/r}ロマノフ
EnemyName_091	トクシュ{r[へい]}兵{/r}レザノフ
EnemyName_092	{r[たいちょう]}隊長{/r}ストロガノフ
EnemyName_Sosuna	{r[しょうぐん]}将軍{/r}ソスナ
EnemyName_095	トツゲキ{r[へい]}兵{/r}ゲルマン
EnemyName_096	コウサク{r[へい]}兵{/r}ローマン
EnemyName_097	トクシュ{r[へい]}兵{/r}ベルマン
EnemyName_098	{r[たいちょう]}隊長{/r}ペレルマン
EnemyName_099	テイコク{r[へい]}兵{/r}イワノフ
EnemyName_100	トツゲキ{r[へい]}兵{/r}ペシコフ
EnemyName_101	コウサク{r[へい]}兵{/r}トンコフ
EnemyName_102	トクシュ{r[へい]}兵{/r}ゴリコフ
EnemyName_103	{r[たいちょう]}隊長{/r}ナボコフ
EnemyName_104	{r[えいへい]}衛兵{/r}ゴーリキー
EnemyName_106	トツゲキ{r[へい]}兵{/r}コベキン
EnemyName_107	コウサク{r[へい]}兵{/r}パンキン
EnemyName_108	トクシュ{r[へい]}兵{/r}ブリキン
EnemyName_109	{r[たいちょう]}隊長{/r}ポチョムキン
EnemyName_110	{r[かんしゅ]}看守{/r}ヴォルコフ
EnemyName_112	トツゲキ{r[へい]}兵{/r}レドネフ
EnemyName_113	コウサク{r[へい]}兵{/r}カメネフ
EnemyName_114	トクシュ{r[へい]}兵{/r}バラネフ
EnemyName_115	{r[たいちょう]}隊長{/r}ツルゲネフ
EnemyName_117	トツゲキ{r[へい]}兵{/r}ムロイ
EnemyName_118	コウサク{r[へい]}兵{/r}ルツコイ
EnemyName_119	トクシュ{r[へい]}兵{/r}マツイ
EnemyName_120	{r[たいちょう]}隊長{/r}トルストイ
EnemyName_121	{r[でんじほう]}電磁砲{/r}ステチキン
EnemyName_122	トツゲキ{r[へい]}兵{/r}アドロフ
EnemyName_123	コウサク{r[へい]}兵{/r}カルロフ
EnemyName_124	トクシュ{r[へい]}兵{/r}トポロフ
EnemyName_125	{r[たいちょう]}隊長{/r}カスパロフ
EnemyName_126	トツゲキ{r[へい]}兵{/r}ナカムラ
EnemyName_127	コウサク{r[へい]}兵{/r}ニシムラ
EnemyName_128	トクシュ{r[へい]}兵{/r}シマムラ
EnemyName_129	{r[たいちょう]}隊長{/r}ユキムラ
EnemyName_130	{r[でんじほう]}電磁砲{/r}ドラグノフ
EnemyName_132	トツゲキ{r[へい]}兵{/r}ヤン
EnemyName_133	コウサク{r[へい]}兵{/r}ルビン
EnemyName_134	トクシュ{r[へい]}兵{/r}リシン
EnemyName_135	{r[たいちょう]}隊長{/r}ラスプーチン
EnemyName_137	トツゲキ{r[へい]}兵{/r}シン
EnemyName_138	コウサク{r[へい]}兵{/r}ハポン
EnemyName_139	トクシュ{r[へい]}兵{/r}カーン
EnemyName_140	{r[たいちょう]}隊長{/r}アルスラン
EnemyName_141	{r[してんのう]}四天王{/r}サルマン
EnemyName_142	{r[してんのう]}四天王{/r}ラフマン
EnemyName_143	{r[してんのう]}四天王{/r}ケトマン
EnemyName_144	{r[してんのう]}四天王{/r}ノイマン
EnemyName_Glado	{r[こうてい]}皇帝{/r}グラード
EnemyName_221	チョウサ{r[へい]}兵{/r}ペトロフ
EnemyName_222	チョウサ{r[へい]}兵{/r}ゴレロフ
EnemyName_223	チョウサ{r[へい]}兵{/r}マニロフ
EnemyName_224	{r[たいちょう]}隊長{/r}シドロフ
EnemyName_225	チョウサ{r[へい]}兵{/r}ロマキナ
EnemyName_226	チョウサ{r[へい]}兵{/r}レスキナ
EnemyName_227	チョウサ{r[へい]}兵{/r}マルキナ
EnemyName_228	{r[たいちょう]}隊長{/r}カニスキナ
EnemyName_233	トツゲキ{r[へい]}兵{/r}オルロフ
EnemyName_234	コウサク{r[へい]}兵{/r}コズロフ
EnemyName_235	トクシュ{r[へい]}兵{/r}マロフ
EnemyName_236	{r[たいちょう]}隊長{/r}キーロフ
EnemyName_237	チョウサ{r[へい]}兵{/r}ソコロフ
EnemyName_238	チョウサ{r[へい]}兵{/r}カウロフ
EnemyName_239	チョウサ{r[へい]}兵{/r}ブーロフ
EnemyName_240	{r[たいちょう]}隊長{/r}ナザロフ
EnemyName_249	チョウサ{r[へい]}兵{/r}クドー
EnemyName_250	チョウサ{r[へい]}兵{/r}ゴドー
EnemyName_251	チョウサ{r[へい]}兵{/r}エンドー
EnemyName_252	{r[たいちょう]}隊長{/r}トードー
EnemyName_255	チョウサ{r[へい]}兵{/r}ローゾフ
EnemyName_256	チョウサ{r[へい]}兵{/r}ブーゾフ
EnemyName_257	チョウサ{r[へい]}兵{/r}シゾフ
EnemyName_258	{r[たいちょう]}隊長{/r}モロゾフ
EnemyName_259	トツゲキ{r[へい]}兵{/r}シュビン
EnemyName_260	コウサク{r[へい]}兵{/r}トルビン
EnemyName_261	トクシュ{r[へい]}兵{/r}グービン
EnemyName_262	{r[たいちょう]}隊長{/r}スクリャビン
EnemyName_263	チョウサ{r[へい]}兵{/r}パブロワ
EnemyName_264	チョウサ{r[へい]}兵{/r}ヤムキン
EnemyName_265	チョウサ{r[へい]}兵{/r}ハフキン
EnemyName_266	チョウサ{r[へい]}兵{/r}モロキン
EnemyName_267	{r[たいちょう]}隊長{/r}プーシキン
EnemyName_268	ランボルギーニン
EnemyName_271	{r[じゅじゅつし]}呪術師{/r}セイメイ
EnemyName_197	トツゲキ{r[へい]}兵{/r}ヤンゲリ
EnemyName_198	コウサク{r[へい]}兵{/r}ムシェリ
EnemyName_199	トクシュ{r[へい]}兵{/r}ペステリ
EnemyName_200	{r[たいちょう]}隊長{/r}ゴーゴリ
EnemyName_201	{r[〿ちょう]}超{/r}トツゲキ{r[へい]}兵{/r}ドラコ
EnemyName_202	{r[〿ちょう]}超{/r}トクシュ{r[へい]}兵{/r}タイガ
EnemyName_203	エリート{r[へい]}兵{/r}グリエフ
EnemyName_204	エリート{r[へい]}兵{/r}サラエフ
EnemyName_205	エリート{r[へい]}兵{/r}ユリエフ
EnemyName_206	{r[たいちょう]}隊長{/r}ゲルギエフ
EnemyName_253	チョウサ{r[へい]}兵{/r}アクバル
EnemyName_254	{r[たいちょう]}隊長{/r}ガンニバル
EnemyName_209	トツゲキ{r[へい]}兵{/r}ロッセリ
EnemyName_210	コウサク{r[へい]}兵{/r}ラッテリ
EnemyName_211	トクシュ{r[へい]}兵{/r}バーベリ
EnemyName_212	{r[たいちょう]}隊長{/r}ステッセリ
EnemyName_213	エリート{r[へい]}兵{/r}ベダレフ
EnemyName_214	エリート{r[へい]}兵{/r}コムレフ
EnemyName_215	エリート{r[へい]}兵{/r}カーレフ
EnemyName_216	{r[たいちょう]}隊長{/r}バラキレフ
EnemyName_217	{r[でんじほう]}電磁砲{/r}ニコノフ
EnemyName_218	{r[しょちょう]}所長{/r}チェレンコフ
EnemyName_269	チョウサ{r[へい]}兵{/r}アヴェン
EnemyName_270	{r[たいちょう]}隊長{/r}ナディン
EnemyName_219	{r[しゅりょう]}首領{/r}ワルーエフ
EnemyName_273	エリート{r[へい]}兵{/r}マカロワ
EnemyName_276	{r[たいちょう]}隊長{/r}ジューコフ
EnemyName_Ablicos_00	アブリコス
EnemyName_Sosuna_00	ソスナ
EnemyName_279	エリート{r[へい]}兵{/r}クライン
EnemyName_Yulia_00	ユーリア
EnemyName_Glado_00	グラード
EnemyName_282	{r[たいちょう]}隊長{/r}コスギン
EnemyName_Grom_00	グロム
EnemyName_Bambooque_00	バンブーク
EnemyName_285	エリート{r[へい]}兵{/r}オオシゲ
EnemyName_286	{r[でんじほう]}電磁砲{/r}フェドロフ
EnemyName_Musashi	ムサシ
EnemyName_291	エリート{r[へい]}兵{/r}レスコフ
EnemyName_294	エリート{r[へい]}兵{/r}メビウス
EnemyName_297	エリート{r[へい]}兵{/r}ユーギン
EnemyName_300	{r[たいちょう]}隊長{/r}ムラシゲ
EnemyName_C_001	トツゲキ{r[へい]}兵{/r}タルノフ
EnemyName_C_002	コウサク{r[へい]}兵{/r}クラノフ
EnemyName_C_003	トクシュ{r[へい]}兵{/r}ペガノフ
EnemyName_C_004	{r[たいちょう]}隊長{/r}アクショノフ
EnemyName_C_005	チョウサ{r[へい]}兵{/r}コスギン
EnemyName_C_006	トツゲキ{r[へい]}兵{/r}ソルキン
EnemyName_C_007	コウサク{r[へい]}兵{/r}ロトキン
EnemyName_C_008	トクシュ{r[へい]}兵{/r}バラキン
EnemyName_C_009	{r[たいちょう]}隊長{/r}クロポトキン
EnemyName_C_010	チョウサ{r[へい]}兵{/r}ユーギン
EnemyName_C_011	トツゲキ{r[へい]}兵{/r}コスチナ
EnemyName_C_012	コウサク{r[へい]}兵{/r}ニコチナ
EnemyName_C_013	トクシュ{r[へい]}兵{/r}チェチナ
EnemyName_C_014	{r[たいちょう]}隊長{/r}カーチナ
EnemyName_C_015	チョウサ{r[へい]}兵{/r}マギン
EnemyName_C_016	トツゲキ{r[へい]}兵{/r}アリエフ
EnemyName_C_017	コウサク{r[へい]}兵{/r}カラエフ
EnemyName_C_018	トクシュ{r[へい]}兵{/r}ベリエフ
EnemyName_C_019	{r[たいちょう]}隊長{/r}メンデレエフ
EnemyName_C_020	{r[しれい]}司令{/r}アクーギン
EnemyName_C_021	エリート{r[へい]}兵{/r}ペトロフ
EnemyName_C_022	エリート{r[へい]}兵{/r}ゴルロフ
EnemyName_C_023	エリート{r[へい]}兵{/r}グーロフ
EnemyName_C_024	{r[たいちょう]}隊長{/r}ガブリロフ
EnemyName_C_025	{r[でんじほう]}電磁砲{/r}フェドロフ
StarGet_WinGod	%lsを{r[つか]}使{/r}って{r[しょうり]}勝利{/r}
StarGet_WinSushiEatMore	%d皿{r[た]}食{/r}べて{r[しょうり]}勝利{/r}
StarGet_WinSushiEatLess	%d皿{r[いない]}以内{/r}で{r[しょうり]}勝利{/r}
StarGet_WinSushiEatKind	%d{r[しゅるい]}種類{/r}のネタを{r[た]}食{/r}べて{r[しょうり]}勝利{/r}
StarGet_WinPile	%d皿{r[いじょう]}以上{/r}つなげて{r[しょうり]}勝利{/r}
StarGet_WinFavEat	{r[こうぶつ]}好物{/r}を%d皿{r[た]}食{/r}べて{r[しょうり]}勝利{/r}
StarGet_WinRainbow	{r[にじざら]}虹皿{/r}を%d回{r[つく]}作{/r}って{r[しょうり]}勝利{/r}
StarGet_WinCombo	%dコンボ{r[たっせい]}達成{/r}して{r[しょうり]}勝利{/r}
StarGet_WinBreak	{r[てき]}敵{/r}の{r[さら]}皿{/r}を%d枚{r[わ]}割{/r}って{r[しょうり]}勝利{/r}
StarGet_WinSkill	スキルを%d回{r[つか]}使{/r}って{r[しょうり]}勝利{/r}
StarGet_WinSkill_sgl	スキルを%d回{r[つか]}使{/r}って{r[しょうり]}勝利{/r}
StarGet_WinLessSkill	スキル{r[しよう]}使用{/r}%d回{r[いか]}以下{/r}で{r[しょうり]}勝利{/r}
StarGet_WinLessSkill_sgl	スキル{r[しよう]}使用{/r}%d回{r[いか]}以下{/r}で{r[しょうり]}勝利{/r}
StarGet_WinNoSkill	スキルを{r[つか]}使{/r}わずに{r[しょうり]}勝利{/r}
StarGet_WinFes	スシ{r[まつ]}祭{/r}りを%d回{r[お]}起{/r}こして{r[しょうり]}勝利{/r}
StarGet_WinFes_sgl	スシ{r[まつ]}祭{/r}りを%d回{r[お]}起{/r}こして{r[しょうり]}勝利{/r}
StarGet_WinHpMore	HP%d％{r[いじょう]}以上{/r}を{r[のこ]}残{/r}して{r[しょうり]}勝利{/r}
StarGet_WinTimeLess	%d秒{r[いない]}以内{/r}に{r[しょうり]}勝利{/r}
StarGet_WinScoreMore	スコア%d{r[いじょう]}以上{/r}で{r[しょうり]}勝利{/r}
StarGet_RankA	ランクA{r[いじょう]}以上{/r}を{r[と]}取{/r}って{r[しょうり]}勝利{/r}
StarGet_RankB	ランクB{r[いじょう]}以上{/r}を{r[と]}取{/r}って{r[しょうり]}勝利{/r}
StarGet_OnlyAutoShoot	{r[じどう]}自動{/r}シュートのみで{r[しょうり]}勝利{/r}
StarGet_WinLastAtk	とどめのアタック%d{r[いじょう]}以上{/r}
StarGet_WinPileLess	%d皿{r[いじょうたか]}以上高{/r}く{r[つ]}積{/r}まずに{r[しょうり]}勝利{/r}
StarGet_WinAutoShootLess	{r[じどう]}自動{/r}シュート%d回{r[いか]}以下{/r}で{r[しょうり]}勝利{/r}
StarGet_WinRecover	HPを%d{r[いじょうかいふく]}以上回復{/r}して{r[しょうり]}勝利{/r}
StarGet_WinWithoutGod	%lsを{r[い]}入{/r}れずに{r[しょうり]}勝利{/r}
GodSkillName_Double	{r[ばいばい]}倍々{/r}シュート
GodSkillName_EnemyLaneSpd	{r[ぼうそうとっきゅう]}暴走特急{/r}レーン
GodSkillName_SweetsHeaven	スイーツ{r[てんごく]}天国{/r}
GodSkillName_100Free	{r[ひゃくれんざら]}百連皿{/r}
GodSkillName_Skeleton	{r[とうめい]}透明{/r}ライカー
GodSkillName_Wasabi	ワサビ{r[だい]}大{/r}サービス
GodSkillName_Oke	じゃまオケ{r[じごく]}地獄{/r}
GodSkillName_ShockShoot	{r[でんげき]}電撃{/r}シュート
GodSkillName_BarrierShield	バリアシールド
GodSkillName_EatVacuum	バキューム{r[ぐ]}食{/r}い
GodSkillName_YoursIsMine	お{r[まえ]}前{/r}のスシは{r[おれ]}俺{/r}のスシ
GodSkillName_AddInsidiouslyDish	いつの{r[ま]}間{/r}に{r[ついかざら]}追加皿{/r}
GodSkillName_SkillCharge	{r[ちょうそく]}超速{/r}スキルチャージ
GodSkillName_DishRankEne	{r[さらいろ]}皿色{/r}グレードダウン
GodSkillName_LaneSpdAll	ダブル{r[きゅうこう]}急行{/r}レーン
GodSkillName_SkillUseNgAll	{r[りょうじん]}両陣{/r}スキル{r[きんしれい]}禁止令{/r}
GodSkillName_SkillUseNgEne	{r[てきじん]}敵陣{/r}スキル{r[きんしれい]}禁止令{/r}
GodSkillName_DishAtkUp	{r[さら]}皿{/r}クラッシャー
GodSkillName_DirectAttack	グレートアロー
GodSkillName_LifeHunter	ライフハンター
GodSkillName_EatMyway	マイウェイ{r[ぐ]}食{/r}い
GodSkillName_SoulShoot	ソウルシュート
GodSkillName_SkillGaugeHunt	スキルパワーハンター
GodSkillName_FesHunt	お{r[まつ]}祭{/r}りハンター
GodSkillName_TableBreak	テーブルアロー
GodSkillName_TableDishLifeup	つみ{r[ざらちょうかいふく]}皿超回復{/r}
GodSkillName_ComboBonus	コンボキャンペーン
GodSkillName_NgAutoShoot	{r[じどう]}自動{/r}シュート{r[ふういん]}封印{/r}
GodSkillName_DamageReflection	{r[ぜんりょく]}全力{/r}しっぺ{r[かえ]}返{/r}し
GodSkillName_RobSheld	ぶんどりシールド
GodSkillName_FruitsParadise	フルーツパラダイス
GodSkillName_HpChange	{r[うんめいこうかん]}運命交換{/r}
GodSkillName_SkillTerminate	スキルクリーン
GodSkillName_CmnMonopoly	{r[どくせんきょうつう]}独占共通{/r}レーン
GodSkillName_SkillCopy	スキルコピー
GodSkillName_DishInvisible	{r[しっこくざら]}漆黒皿{/r}
GodSkillName_DishWall	{r[はちさら]}八皿{/r}ウォール
GodSkillName_LivemonitorOwn	スーパースター
GodSkillName_LivemonitorEne	スーパースカウト
GodSkillName_ShockShoot2	{r[らいげき]}雷撃{/r}シュート
GodSkillName_SushiDisappear	スシ{r[き]}消{/r}え～る
GodSkillName_LaneHighClass	{r[こうきゅう]}高級{/r}ライカー
GodSkillName_LaneFill	スシ{r[づ]}詰{/r}め{r[てんごく]}天国{/r}
GodSkillName_LightClothes	ヒカリノコロモ
GodSkillName_ShrineBlind	{r[ぜつぼう]}絶望{/r}の{r[かべ]}壁{/r}
GodSkillName_SushiShuffleer	スシシャッフラー
GodSkillName_BombSend	ボムおく～る
GodSkillName_TubConveyor	オケ{r[はざま]}狭間{/r}の{r[たたか]}戦{/r}い
GodSkillName_DishReducer	{r[さら]}皿{/r}ちぢ～む
GodSkillName_LaneLowClass	お{r[て]}手{/r}ごろライカー
GodSkillName_ComboWall	コンボウォール
ItemName_Burner	あぶりバーナー
ItemName_OhudaExpS	けいけんのおふだ{r[しょう]}小{/r}
ItemName_OhudaExpM	けいけんのおふだ{r[ちゅう]}中{/r}
ItemName_OhudaExpL	けいけんのおふだ{r[だい]}大{/r}
ItemName_OhudaDefS	まもりのおふだ{r[しょう]}小{/r}
ItemName_OhudaDefM	まもりのおふだ{r[ちゅう]}中{/r}
ItemName_OhudaDefL	まもりのおふだ{r[だい]}大{/r}
ItemName_OhudaSkill	スキルのおふだ
ItemName_OhudaSkillC	スキルのおふだ{r[だい]}大{/r}
ItemName_PlayerHpS	スタミナのかんづめ
ItemName_PlayerAtkS	ちからのかんづめ
ItemName_GearHero	スシライカーズギア
ItemName_GearSuper	スーパーギア
ItemName_GearHyper	ハイパーギア
ItemName_GearUltimate	アルティメットギア
ItemName_GearStream	ストリームギア
ItemName_GearQuick	クイックギア
ItemName_GearLittle	リトルギア
ItemName_ReadyRetryS	ふっかつのまめ{r[しょう]}小{/r}
ItemName_ReadyRetryM	ふっかつのまめ{r[ちゅう]}中{/r}
ItemName_ReadyRetryL	ふっかつのまめ{r[だい]}大{/r}
ItemName_ReadyRetryC	{r[ちょう]}超{/r}ふっかつのまめ
ItemName_ScenarioSukajan	スカジャン
ItemName_ScenarioDictionary	スシガミ{r[だいひゃっか]}大百科{/r}
ItemName_ScenarioHelp	スシライカー{r[とら]}虎{/r}の{r[まき]}巻{/r}
ItemName_ScenarioKey01	アブリコスのカギ
ItemName_ScenarioKey02	バンブークのカギ
ItemName_ScenarioKey03	ソスナのカギ
ItemName_Stone	ふしぎな{r[いし]}石{/r}
ItemName_StoneBig	ふしぎな{r[まるいし]}丸石{/r}
ItemName_OhudaPT	パーティーのおふだ
ItemName_LimitOverScore	{r[しゅぎょう]}修行{/r}の{r[くろおび]}黒帯{/r}
ItemName_ResearchDoc	ひみつの{r[けんきゅうしりょう]}研究資料{/r}
ItemName_ContractDish00	みけいやくの{r[さら]}皿{/r}
ItemName_ContractDish01	みけいやくの{r[さら]}皿{/r}
ItemName_ContractDish02	みけいやくの{r[さら]}皿{/r}
ItemName_ContractDish03	みけいやくの{r[さら]}皿{/r}
ItemName_ContractDish04	みけいやくの{r[さら]}皿{/r}
ItemName_ContractDish05	みけいやくの{r[さら]}皿{/r}
ItemName_ContractDish06	みけいやくの{r[さら]}皿{/r}
ItemName_ContractDish07	みけいやくの{r[さら]}皿{/r}
ItemName_ContractDish08	みけいやくの{r[さら]}皿{/r}
ItemName_ContractDish09	みけいやくの{r[さら]}皿{/r}
ItemName_ContractDish10	みけいやくの{r[さら]}皿{/r}
ItemName_ContractDish11	みけいやくの{r[さら]}皿{/r}
ItemName_ContractDish12	みけいやくの{r[さら]}皿{/r}
ItemName_Burner_lc	あぶりバーナー
ItemName_PlayerHpS_lc	スタミナのかんづめ
ItemName_PlayerAtkS_lc	ちからのかんづめ
ItemName_GearSuper_lc	スーパーギア
ItemName_GearStream_lc	ストリームギア
ItemName_ReadyRetryS_lc	ふっかつのまめ{r[しょう]}小{/r}
ItemName_ReadyRetryM_lc	ふっかつのまめ{r[ちゅう]}中{/r}
ItemName_ReadyRetryL_lc	ふっかつのまめ{r[だい]}大{/r}
ItemName_ReadyRetryC_lc	{r[ちょう]}超{/r}ふっかつのまめ
ItemName_LimitOverScore_lc	{r[しゅぎょう]}修行{/r}の{r[くろおび]}黒帯{/r}
ItemName_ContractDish00_lc	みけいやくの{r[さら]}皿{/r}
ItemName_ContractDish01_lc	みけいやくの{r[さら]}皿{/r}
ItemName_ContractDish02_lc	みけいやくの{r[さら]}皿{/r}
ItemName_ContractDish03_lc	みけいやくの{r[さら]}皿{/r}
ItemName_ContractDish04_lc	みけいやくの{r[さら]}皿{/r}
ItemName_ContractDish05_lc	みけいやくの{r[さら]}皿{/r}
ItemName_ContractDish06_lc	みけいやくの{r[さら]}皿{/r}
ItemName_ContractDish07_lc	みけいやくの{r[さら]}皿{/r}
ItemName_ContractDish08_lc	みけいやくの{r[さら]}皿{/r}
ItemName_ContractDish09_lc	みけいやくの{r[さら]}皿{/r}
ItemName_ContractDish10_lc	みけいやくの{r[さら]}皿{/r}
ItemName_ContractDish11_lc	みけいやくの{r[さら]}皿{/r}
ItemName_ContractDish12_lc	みけいやくの{r[さら]}皿{/r}
ItemName_CollaboTicket	チャレンジけん
ItemName_CollaboItem01	まぐろラッコのまぐろ
ItemName_CollaboItem02	スシローのおふだ
ItemName_CollaboItem03	スシローのおまもり
ItemName_CollaboTicket_lc	チャレンジけん
ItemName_CollaboItem01_lc	まぐろラッコのまぐろ
ItemName_CollaboItem02_lc	スシローのおふだ
ItemName_CollaboItem03_lc	スシローのおまもり
GodName_God001	ジンライ
GodName_God002	ジンライ
GodName_God003	ジンライ
GodName_God004	アラオウ
GodName_God005	アラオウ
GodName_God007	キャッテン
GodName_God008	キャッテン
GodName_God010	クマテン
GodName_God011	クマテン
GodName_God012	クマテン
GodName_God013	ユニカン
GodName_God014	ユニカン
GodName_God016	ペンゾー
GodName_God017	ペンゾー
GodName_God018	ペンゾー
GodName_God019	オルテン
GodName_God020	オルテン
GodName_God022	サボカン
GodName_God023	サボカン
GodName_God025	ピョンテン
GodName_God026	ピョンテン
GodName_God027	ピョンテン
GodName_God028	イナゾー
GodName_God029	イナゾー
GodName_God031	モグゾー
GodName_God034	ゴクオウ
GodName_God035	ゴクオウ
GodName_God037	スイテン
GodName_God038	スイテン
GodName_God042	ゴウライ
GodName_God043	トラゾー
GodName_God044	トラゾー
GodName_God045	トラゾー
GodName_God046	クリステン
GodName_God047	クリステン
GodName_God048	クリステン
GodName_God049	ホノカン
GodName_God050	ホノカン
GodName_God051	ホノカン
GodName_God052	チェリカン
GodName_God053	チェリカン
GodName_God054	チェリカン
GodName_God055	ロズカン
GodName_God056	ロズカン
GodName_God057	ロズカン
GodName_God058	リュウカン
GodName_God059	リュウカン
GodName_God060	リュウカン
GodName_God061	エレカン
GodName_God062	エレカン
GodName_God063	エレカン
GodName_God064	ボンテン
GodName_God065	ボンテン
GodName_God066	ボンテン
GodName_God067	バッテン
GodName_God068	バッテン
GodName_God069	バッテン
GodName_God070	ドルカン
GodName_God071	ドルカン
GodName_God073	ホウテン
GodName_God074	ホウテン
GodName_God076	カズラサツ
GodName_God077	カズラサツ
GodName_God079	ユキゾー
GodName_God080	ユキゾー
GodName_God082	スノゾー
GodName_God083	スノゾー
GodName_God085	ガロオウ
GodName_God086	ガロオウ
GodName_God088	カメレサツ
GodName_God089	カメレサツ
GodName_God091	ウッソー
GodName_God094	ケロゾー
GodName_God097	ギュウゾー
GodName_God098	ギュウゾー
GodName_God100	マウソー
GodName_God103	ハッカン
GodName_God104	ハッカン
GodName_God106	コンカン
GodName_God107	コンカン
GodName_God109	カマオウ
GodName_God112	クラウゾー
GodName_God113	クラウゾー
GodName_God115	タケゾー
GodName_God116	タケゾー
GodName_God118	ゴレカン
GodName_God119	ゴレカン
GodName_God121	バケゾー
GodName_God122	バケゾー
GodName_God124	ヘルゾー
GodName_God125	ヘルゾー
GodName_God127	ノムゾー
GodName_God128	ノムゾー
GodName_God130	バクゾー
GodName_God131	バクゾー
GodName_God133	プラオウ
GodName_God134	プラオウ
GodName_God136	ポポカン
GodName_God137	ポポカン
GodName_God139	フェアテン
GodName_God140	フェアテン
GodName_God142	ワニオウ
GodName_God145	クロカン
GodName_God146	クロカン
GodName_God148	アヌビサツ
GodName_GodC001	まぐろラッコ
GodName_GodC002	いくらパンダ
GodName_GodC003	うにライオン
GodName_GodC004	いかタイガー
GodName_GodC005	えびウサギ
GodName_GodC006	たまコッコ
GodName_GodC007	サーモンしろくま
GodName_GodC008	クマねぎまぐろ
GodName_GodC009	くろねコーン
GodName_GodC010	タコひつじ
GodName_GodC011	はまちネコ
GodName_GodC012	あじカワウソ
GodName_GodC013	ポテトビーバー
SushiLikerRankName_00	初段
SushiLikerRankName_01	２段
SushiLikerRankName_02	３段
SushiLikerRankName_03	４段
SushiLikerRankName_04	５段
SushiLikerRankName_05	６段
SushiLikerRankName_06	７段
SushiLikerRankName_07	８段
SushiLikerRankName_08	９段
SushiLikerRankName_09	１０段
PlayerTitledName_00	{r[きょうわこく]}共和国{/r}の{r[しょうねん]}少年{/r}
PlayerTitledName_00_f	{r[きょうわこく]}共和国{/r}の{r[しょうじょ]}少女{/r}
PlayerTitledName_01	かけだしスシライカー
PlayerTitledName_02	スシ{r[かいほうせんせん]}解放戦線{/r}メンバー
PlayerTitledName_03	{r[ゆうげき]}遊撃{/r}のスシライカー
PlayerTitledName_04	スシ{r[かいほうせんせん]}解放戦線{/r}の{r[きぼう]}希望{/r}
PlayerTitledName_05	{r[さきがけ]}魁{/r}のスシライカー
PlayerTitledName_06	スシ{r[かいほうせんせん]}解放戦線{/r}リーダー
PlayerTitledName_07	{r[しの]}忍{/r}びのスシライカー
PlayerTitledName_08	{r[かんしゃ]}感謝{/r}のスシライカー
PlayerTitledName_09	{r[きぼう]}希望{/r}のスシライカー
PlayerTitledName_10	スーパースシライカー
PlayerName	ムサシ
DecimalPoint	.
\database\database_godInfo.msbt
GodInfo_God001	{r[しろしし]}白獅子{/r}の{r[すがた]}姿{/r}をとったスシガミ。\nスシガミとして{r[さいこうい]}最高位{/r}の{r[ちから]}力{/r}を{r[ひ]}秘{/r}めるという。
GodInfo_God002	{r[すこ]}少{/r}し{r[ちから]}力{/r}を{r[と]}取{/r}り{r[もど]}戻{/r}した{r[すがた]}姿{/r}。たまに\nブラッシングしてあげるとご{r[きげん]}機嫌{/r}になる。
GodInfo_God003	ゴウライと{r[つい]}対{/r}を{r[な]}成{/r}す{r[さいこうい]}最高位{/r}のスシガミ。\n{r[でんせつ]}伝説{/r}のスシガミとして{r[かた]}語{/r}り{r[つ]}継{/r}がれている。
GodInfo_God004	アライグマの{r[すがた]}姿{/r}をとったスシガミ。\nまっすぐ{r[まじめ]}真面目{/r}で、きれい{r[ず]}好{/r}きな{r[しんし]}紳士{/r}。
GodInfo_God005	{r[よご]}汚{/r}れを{r[み]}見{/r}ると{r[そうじ]}掃除{/r}せずにはいられない。\nとにかく{r[なん]}何{/r}でも{r[みず]}水{/r}で{r[あら]}洗{/r}ってしまう。
GodInfo_God007	ネコの{r[すがた]}姿{/r}をとったスシガミ。\nとても{r[かんだい]}寛大{/r}で、{r[ちい]}小{/r}さなことは{r[き]}気{/r}にしない。
GodInfo_God008	{r[くろうにん]}苦労人{/r}や、{r[ぜんこう]}善行{/r}をはたらく{r[もの]}者{/r}には\nスシをたらふく{r[た]}食{/r}べさせてあげるという。
GodInfo_God010	クマの{r[すがた]}姿{/r}をとったスシガミ。\nこの{r[すがた]}姿{/r}からは{r[そうぞう]}想像{/r}もできないほどの{r[ちから]}力{/r}もち。
GodInfo_God011	はりきり{r[や]}屋{/r}さんで、いつも{r[ぜんりょく]}全力{/r}。\n{r[て]}手{/r}を{r[ぬ]}抜{/r}く…という{r[かんかく]}感覚{/r}がわからないという。
GodInfo_God012	{r[げんかく]}厳格{/r}にして{r[けんろう]}堅牢{/r}なるスシガミ。\n{r[たいぼく]}大木{/r}の{r[ごと]}如{/r}き{r[くっきょう]}屈強{/r}な{r[てあし]}手足{/r}で、{r[あいて]}相手{/r}をなぎ{r[たお]}倒{/r}す。
GodInfo_God013	ユニコーンの{r[すがた]}姿{/r}をとったスシガミ。\n{r[はし]}走{/r}ると、キラキラした{r[りゅうし]}粒子{/r}が{r[ちゅう]}宙{/r}を{r[ま]}舞{/r}う。
GodInfo_God014	{r[びてきかんかく]}美的感覚{/r}がとても{r[するど]}鋭{/r}い。{r[み]}見{/r}た{r[め]}目{/r}の{r[うつく]}美{/r}しさより\nも、{r[こころ]}心{/r}の{r[うつく]}美{/r}しさが{r[もっと]}最{/r}も{r[だいじ]}大事{/r}だという。
GodInfo_God016	ペンギンの{r[すがた]}姿{/r}をとったスシガミ。\n{r[おお]}大{/r}きなシルクハットはよくずり{r[お]}落{/r}ちている。
GodInfo_God017	おしゃべりが{r[だいす]}大好{/r}きなマジシャン。\n{r[いきお]}勢{/r}いでタネ{r[あ]}明{/r}かしもしてしまう…らしい。
GodInfo_God018	{r[ごうせい]}豪勢{/r}にして{r[のうべん]}能弁{/r}なるスシガミ。\nいつだって{r[だ]}出{/r}し{r[お]}惜{/r}しみナシの{r[おおばん]}大盤{/r}ぶるまい。
GodInfo_God019	フクロウの{r[すがた]}姿{/r}をとったスシガミ。\n{r[くちぐせ]}口癖{/r}は「ホゥ」だが、ため{r[いき]}息{/r}ではない。
GodInfo_God020	スシとはいったい{r[なん]}何{/r}であるのか…と、\n{r[つね]}常{/r}に{r[かんが]}考{/r}え{r[つづ]}続{/r}けている{r[はくしき]}博識{/r}な{r[てつがくしゃ]}哲学者{/r}。
GodInfo_God022	サボテンの{r[すがた]}姿{/r}をとったスシガミ。\n{r[からだ]}体{/r}のトゲは{r[じぶん]}自分{/r}も{r[いた]}痛{/r}かったので{r[な]}無{/r}くした。
GodInfo_God023	{r[お]}落{/r}ち{r[こ]}込{/r}んでいる{r[とき]}時{/r}には{r[うた]}歌{/r}と{r[おど]}踊{/r}りで{r[はげ]}励{/r}ましてく\nれる、{r[ようき]}陽気{/r}で{r[たの]}頼{/r}もしいエンターテイナー。
GodInfo_God025	ウサギの{r[すがた]}姿{/r}をとったスシガミ。\n{r[おどろ]}驚{/r}いたり{r[こうふん]}興奮{/r}すると{r[みみ]}耳{/r}がピンと{r[た]}立{/r}ち{r[あ]}上{/r}がる。
GodInfo_God026	{r[きゃくりょく]}脚力{/r}だけではなく、{r[わんりょく]}腕力{/r}にも{r[じしん]}自信{/r}あり。\nパワーの{r[みなもと]}源{/r}はジューシーなフルーツらしい。
GodInfo_God027	{r[そうめい]}聡明{/r}にして{r[ゆうかん]}勇敢{/r}なるスシガミ。\n{r[じょうしつ]}上質{/r}な{r[ちりょく]}知力{/r}と{r[からだ]}体{/r}を{r[つく]}作{/r}るのは、{r[もちろん]}勿論{/r}フルーツ。
GodInfo_God028	キツネの{r[すがた]}姿{/r}をとったスシガミ。\nニンジャのごとく、{r[おんみつこうどう]}隠密行動{/r}に{r[た]}長{/r}けている。
GodInfo_God029	つかみどころのない{r[ふしぎ]}不思議{/r}な{r[せいかく]}性格{/r}。\n{r[くちはっちょうてはっちょう]}口八丁手八丁{/r}で、{r[ひと]}人{/r}を{r[ば]}化{/r}かすのが{r[とくい]}得意{/r}。
GodInfo_God031	モグラの{r[すがた]}姿{/r}をとったスシガミ。\nゴーグルの{r[した]}下{/r}には{r[つぶ]}円{/r}らな{r[ひとみ]}瞳{/r}が{r[かく]}隠{/r}されている。
GodInfo_God034	サルの{r[すがた]}姿{/r}をとったスシガミ。\nたまに{r[き]}木{/r}から{r[お]}落{/r}ちることがある。
GodInfo_God035	{r[じゆう]}自由{/r}を{r[あい]}愛{/r}する、まさにフリーダムな{r[せいかく]}性格{/r}。\n{r[かる]}軽{/r}い{r[み]}身{/r}のこなしは{r[きょくげいし]}曲芸師{/r}のように{r[みごと]}見事{/r}。
GodInfo_God037	{r[みず]}水{/r}の{r[せいれい]}精霊{/r}の{r[すがた]}姿{/r}をとったスシガミ。\n{r[こうきしんおうせい]}好奇心旺盛{/r}で、とても{r[ものし]}物知{/r}りな{r[せいかく]}性格{/r}。
GodInfo_God038	{r[さむ]}寒{/r}い{r[ところ]}所{/r}にいくと{r[こお]}凍{/r}ってしまうので、\nホノカンを{r[つ]}連{/r}れていくことが{r[おお]}多{/r}いらしい。
GodInfo_God042	ジンライと{r[つい]}対{/r}を{r[な]}成{/r}す{r[さいこうい]}最高位{/r}のスシガミ。\n{r[けいやくしゃ]}契約者{/r}の{r[こころ]}心{/r}を{r[はんえい]}反映{/r}して{r[のうりょく]}能力{/r}が{r[へんか]}変化{/r}する。
GodInfo_God043	トラの{r[すがた]}姿{/r}をとったスシガミ。\nたまに{r[じぶん]}自分{/r}のシッポにじゃれて{r[あそ]}遊{/r}んでいる。
GodInfo_God044	{r[てあし]}手足{/r}の{r[にくきゅう]}肉球{/r}はぷにぷにで、いつまでも\n{r[さわ]}触{/r}っていたくなる{r[さいこう]}最高{/r}の{r[かんしょく]}感触{/r}である…。
GodInfo_God045	{r[ごうき]}剛毅{/r}にして{r[どうどう]}堂々{/r}たるスシガミ。\n{r[お]}押{/r}して{r[お]}押{/r}して{r[ぜったい]}絶対{/r}に{r[ひ]}引{/r}かぬ{r[きこつ]}気骨{/r}の{r[も]}持{/r}ち{r[ぬし]}主{/r}。
GodInfo_God046	クリスタルの{r[すがた]}姿{/r}をとったスシガミ。\nさわるとほのかに{r[あたた]}温{/r}かく、{r[きも]}気持{/r}ちがいい…。
GodInfo_God047	{r[こうさい]}光彩{/r}を{r[たいない]}体内{/r}で{r[せいせい]}生成{/r}することができる。それら\nが{r[くっせつ]}屈折{/r}して{r[そと]}外{/r}に{r[で]}出{/r}る{r[とき]}時{/r}、{r[からだ]}体{/r}が{r[とうめい]}透明{/r}になる。
GodInfo_God048	{r[こうき]}光輝{/r}にして{r[しんぴ]}神秘{/r}なるスシガミ。\n{r[たたか]}戦{/r}いの{r[きゅうせいしゅ]}救世主{/r}となり、{r[て]}手{/r}を{r[さ]}差{/r}し{r[の]}伸{/r}べる。
GodInfo_God049	ホノオの{r[すがた]}姿{/r}をとったスシガミ。\n{r[は]}晴{/r}れの{r[ひ]}日{/r}と{r[あめ]}雨{/r}の{r[ひ]}日{/r}とでは{r[きぶん]}気分{/r}の{r[さ]}差{/r}が{r[はげ]}激{/r}しい。
GodInfo_God050	{r[ちから]}力{/r}を{r[と]}取{/r}り{r[もど]}戻{/r}した{r[ぶん]}分{/r}、{r[たいおん]}体温{/r}も{r[あ]}上{/r}がった。\n{r[さむ]}寒{/r}い{r[ひ]}日{/r}に{r[そば]}側{/r}にいてほしいスシガミNo.1。
GodInfo_God051	{r[ゆうもう]}勇猛{/r}にして{r[ごうかい]}豪快{/r}なるスシガミ。\n{r[まと]}纏{/r}う{r[ほのお]}炎{/r}は{r[れんごく]}煉獄{/r}の{r[ひ]}火{/r}にも{r[しゅくふく]}祝福{/r}の{r[せいか]}聖火{/r}にもなる。
GodInfo_God052	サクラの{r[すがた]}姿{/r}をとったスシガミ。\nあわてんぼうなところがあり、よくコケる。
GodInfo_God053	{r[はな]}花{/r}びらと{r[いっしょ]}一緒{/r}に{r[おど]}踊{/r}ることが{r[す]}好{/r}き。\nくるりと{r[まわ]}回{/r}れば、{r[はな]}花{/r}ふぶきがとてもきれい。
GodInfo_God054	{r[はくあい]}博愛{/r}と{r[じあい]}慈愛{/r}に{r[み]}満{/r}ちたるスシガミ。\nその{r[ほうようりょく]}包容力{/r}ですべてをやさしく{r[つつ]}包{/r}み{r[こ]}込{/r}む。
GodInfo_God055	バラの{r[すがた]}姿{/r}をとったスシガミ。\n{r[こうき]}高貴{/r}な{r[かお]}香{/r}りと{r[とも]}共{/r}にしゃなりしゃなりと{r[ある]}歩{/r}く。
GodInfo_God056	とてもお{r[じょうひん]}上品{/r}で、お{r[ぎょうぎ]}行儀{/r}がよい。\nスシの{r[しょくじさほう]}食事作法{/r}を{r[かんぺき]}完璧{/r}にマスターしている。
GodInfo_God057	{r[びれい]}美麗{/r}にして{r[ゆうが]}優雅{/r}なるスシガミ。\n{r[あで]}艶{/r}やかな{r[いばら]}茨{/r}は、{r[するど]}鋭{/r}い{r[おと]}音{/r}を{r[た]}立{/r}てて{r[くう]}空{/r}を{r[き]}斬{/r}る。
GodInfo_God058	ドラゴンの{r[すがた]}姿{/r}をとったスシガミ。\n{r[くびもと]}首元{/r}のウロコをなでると、すごく{r[おこ]}怒{/r}る。
GodInfo_God059	{r[はら]}腹{/r}の{r[そこ]}底{/r}に{r[ひび]}響{/r}くような{r[ほうこう]}咆哮{/r}は、{r[き]}聞{/r}けば{r[すこ]}少{/r}しの\n{r[あいだうご]}間動{/r}けなくなってしまう{r[いあつかん]}威圧感{/r}をもつ。
GodInfo_God060	{r[ごうけつ]}豪傑{/r}にして{r[おごそ]}厳{/r}かなるスシガミ。\n{r[あっとうてき]}圧倒的{/r}な{r[ちから]}力{/r}に、{r[だれ]}誰{/r}も{r[さか]}逆{/r}らうことはできない。
GodInfo_God061	ゾウの{r[すがた]}姿{/r}をとったスシガミ。\n{r[おとな]}大人{/r}が{r[お]}押{/r}してもまったく{r[うご]}動{/r}かないほど{r[おも]}重{/r}い。
GodInfo_God062	なんとも{r[ふしぎ]}不思議{/r}な{r[ふえ]}笛{/r}の{r[おと]}音{/r}を{r[ひび]}響{/r}かせながら、\n{r[あざ]}鮮{/r}やかな{r[からだ]}体{/r}を{r[きよう]}器用{/r}に{r[おど]}踊{/r}らせる。
GodInfo_God063	{r[ゆうだい]}雄大{/r}にして{r[こうごう]}神々{/r}しきスシガミ。\n{r[はな]}放{/r}つ{r[はしゃ]}覇者{/r}たるオーラは、{r[ぜったいてき]}絶対的{/r}な{r[たて]}盾{/r}となる。
GodInfo_God064	ガイコツの{r[すがた]}姿{/r}をとったスシガミ。\n{r[よなか]}夜中{/r}に{r[かがみ]}鏡{/r}を{r[み]}見{/r}ては、{r[じぶん]}自分{/r}の{r[すがた]}姿{/r}に{r[おどろ]}驚{/r}いている。
GodInfo_God065	{r[て]}手{/r}に{r[も]}持{/r}つ{r[とけい]}時計{/r}の{r[はり]}針{/r}がとろけてしまっているの\nは、{r[きょうだい]}強大{/r}な{r[まりょく]}魔力{/r}による{r[えいきょう]}影響{/r}らしい。
GodInfo_God066	{r[やみよ]}闇夜{/r}に{r[と]}溶{/r}けし{r[こんとん]}混沌{/r}のスシガミ。\n{r[おのれ]}己{/r}の{r[たましい]}魂{/r}をも{r[ぎせい]}犠牲{/r}にし、{r[いくさ]}戦{/r}の{r[しょうり]}勝利{/r}を{r[もと]}求{/r}める。
GodInfo_God067	コウモリの{r[すがた]}姿{/r}をとったスシガミ。\n{r[ち]}血{/r}ではなく、トマトジュースを{r[の]}飲{/r}む。
GodInfo_God068	{r[きほんてき]}基本的{/r}に{r[さか]}逆{/r}さ{r[づ]}吊{/r}りで{r[す]}過{/r}ごす。\n{r[おと]}音{/r}に{r[びんかん]}敏感{/r}で、{r[すいみんちゅう]}睡眠中{/r}も{r[かす]}微{/r}かな{r[ものおと]}物音{/r}で{r[お]}起{/r}きる。
GodInfo_God069	{r[ようえん]}妖艶{/r}にして{r[いだい]}偉大{/r}なるスシガミ。\n{r[め]}目{/r}を{r[あ]}合{/r}わせれば、{r[だれ]}誰{/r}しも{r[みりょう]}魅了{/r}されてしまう。
GodInfo_God070	ゴスロリ{r[にんぎょう]}人形{/r}の{r[すがた]}姿{/r}をとったスシガミ。\n{r[まいにち]}毎日{/r}1{r[かい]}回{/r}「{r[じゃがん]}邪眼{/r}がうずくわ…」とつぶやく。
GodInfo_God071	{r[ていきてき]}定期的{/r}にゼンマイを{r[まわ]}回{/r}して{r[げんき]}元気{/r}にしてあげる\nのも、スシライカーの{r[りっぱ]}立派{/r}な{r[しごと]}仕事{/r}である。
GodInfo_God073	ホウオウの{r[すがた]}姿{/r}をとったスシガミ。\nぼんやりと{r[ひか]}光{/r}る{r[からだ]}体{/r}は、{r[よいやみ]}宵闇{/r}で{r[めじるし]}目印{/r}となる。
GodInfo_God074	スシを{r[た]}食{/r}べるとき、{r[ぎょうぎ]}行儀{/r}の{r[わる]}悪{/r}い{r[もの]}者{/r}には\n{r[ようしゃ]}容赦{/r}なく{r[ばつ]}罰{/r}をくだす。
GodInfo_God076	ツルの{r[すがた]}姿{/r}をとったスシガミ。\n{r[おだ]}穏{/r}やかな{r[せいかく]}性格{/r}だが、{r[わら]}笑{/r}い{r[かた]}方{/r}がちょっと{r[こわ]}怖{/r}い。
GodInfo_God077	{r[じゅうなん]}柔軟{/r}に{r[うご]}動{/r}くツルで、{r[なん]}難{/r}なく{r[さら]}皿{/r}を{r[うば]}奪{/r}っていく。\n{r[ひ]}日{/r}の{r[あ]}当{/r}たる{r[ばしょ]}場所{/r}では、より{r[はや]}速{/r}く{r[うご]}動{/r}く。
GodInfo_God079	ユキダルマの{r[すがた]}姿{/r}をとったスシガミ。\n{r[じぶん]}自分{/r}に{r[きび]}厳{/r}しく、{r[あいて]}相手{/r}にも{r[きび]}厳{/r}しい{r[せいかく]}性格{/r}。
GodInfo_God080	{r[つめ]}冷{/r}たい{r[た]}食{/r}べ{r[もの]}物{/r}が{r[す]}好{/r}きなので、\nスシもキンキンに{r[ひ]}冷{/r}やしてしまうらしい。
GodInfo_God082	ユキダルマの{r[すがた]}姿{/r}をとったスシガミ。\n{r[じぶん]}自分{/r}に{r[あま]}甘{/r}く、{r[あいて]}相手{/r}には{r[きび]}厳{/r}しい{r[せいかく]}性格{/r}。
GodInfo_God083	{r[てさき]}手先{/r}が{r[きよう]}器用{/r}で、マフラーと{r[てぶくろ]}手袋{/r}は{r[てあ]}手編{/r}み。\nスペアもたくさん{r[ようい]}用意{/r}している。
GodInfo_God085	オオカミの{r[すがた]}姿{/r}をとったスシガミ。\n{r[しっけ]}湿気{/r}の{r[おお]}多{/r}い{r[ばしょ]}場所{/r}では{r[さかだ]}逆立{/r}った{r[たいもう]}体毛{/r}がへたる。
GodInfo_God086	{r[だれ]}誰{/r}よりも{r[なかまおも]}仲間思{/r}いなリーダー{r[きしつ]}気質{/r}。\n{r[れいせい]}冷静{/r}な{r[ひとみ]}瞳{/r}の{r[おく]}奥{/r}で、{r[たし]}確{/r}かな{r[じょうねつ]}情熱{/r}を{r[も]}燃{/r}やす。
GodInfo_God088	カメレオンの{r[すがた]}姿{/r}をとったスシガミ。\n{r[した]}舌{/r}と{r[しっぽ]}尻尾{/r}を{r[どうじ]}同時{/r}に{r[うご]}動{/r}かすことができる。
GodInfo_God089	{r[にじいろ]}虹色{/r}の{r[ふしぎ]}不思議{/r}なケープで、あらゆる{r[ちから]}力{/r}を{r[きゅうしゅう]}吸収{/r}\nし、{r[じぶん]}自分{/r}のものにしてしまう。
GodInfo_God091	カワウソの{r[すがた]}姿{/r}をとったスシガミ。\nおどけた{r[かお]}顔{/r}をしているが、{r[けっこう]}結構{/r}な{r[あば]}暴{/r}れん{r[ぼう]}坊{/r}。
GodInfo_God094	カエルの{r[すがた]}姿{/r}をとったスシガミ。\n{r[ひとみ]}瞳{/r}が{r[かいがん]}開眼{/r}する{r[とき]}時{/r}、{r[なに]}何{/r}かが{r[お]}起{/r}こるという…。
GodInfo_God097	ウシの{r[すがた]}姿{/r}をとったスシガミ。\n{r[じんぎ]}仁義{/r}に{r[あつ]}厚{/r}く、{r[くちぐせ]}口癖{/r}は「かたじけない」。
GodInfo_God098	{r[がんけん]}頑健{/r}な{r[からだ]}体{/r}に{r[やさ]}優{/r}しい{r[こころ]}心{/r}を{r[も]}持{/r}つ。{r[せんとうたいせい]}戦闘態勢{/r}に\n{r[はい]}入{/r}ると{r[お]}尾{/r}を{r[からだ]}体{/r}に{r[たた]}叩{/r}きつけ、{r[みずか]}自{/r}らを{r[こぶ]}鼓舞{/r}する。
GodInfo_God100	ネズミの{r[すがた]}姿{/r}をとったスシガミ。\n{r[からだ]}体{/r}は{r[ちい]}小{/r}さいが、{r[たいど]}態度{/r}と{r[じしん]}自信{/r}はとても{r[おお]}大{/r}きい。
GodInfo_God103	カメの{r[すがた]}姿{/r}をとったスシガミ。\nコンカンより{r[じぶん]}自分{/r}の{r[ほう]}方{/r}が{r[かた]}固{/r}いことが{r[じまん]}自慢{/r}。
GodInfo_God104	スピーカーからは{r[ふる]}古{/r}き{r[よ]}良{/r}き{r[かようきょく]}歌謡曲{/r}が{r[なが]}流{/r}れてい\nる。{r[うた]}歌{/r}は{r[じょうねつ]}情熱{/r}が{r[いのち]}命{/r}！と{r[しゅちょう]}主張{/r}。
GodInfo_God106	カメの{r[すがた]}姿{/r}をとったスシガミ。\nハッカンより{r[じぶん]}自分{/r}の{r[ほう]}方{/r}が{r[かた]}固{/r}いことが{r[じまん]}自慢{/r}。
GodInfo_God107	スピーカーからはイマドキなヒップホップが\n{r[なが]}流{/r}れている。{r[うた]}歌{/r}は{r[りゅうこう]}流行{/r}が{r[いのち]}命{/r}！と{r[しゅちょう]}主張{/r}。
GodInfo_God109	カマイタチの{r[すがた]}姿{/r}をとったスシガミ。\n{r[おと]}音{/r}もなくワサビ{r[ざら]}皿{/r}を{r[しこ]}仕込{/r}む{r[さま]}様{/r}はまさに{r[せんぷう]}旋風{/r}。
GodInfo_God112	クモの{r[すがた]}姿{/r}をとったスシガミ。\nスシガミ{r[かい]}界{/r}{r[ずいいち]}随一{/r}のあっけらかんとした{r[せいかく]}性格{/r}。
GodInfo_God113	{r[じざい]}自在{/r}に{r[てんき]}天気{/r}を{r[あやつ]}操{/r}れる。お{r[ねが]}願{/r}いすれば、\n{r[なつ]}夏{/r}でも{r[ゆき]}雪{/r}を{r[ふ]}降{/r}らせてくれる。
GodInfo_God115	キノコの{r[すがた]}姿{/r}をとったスシガミ。\nちょっとした{r[しょうげき]}衝撃{/r}でも、{r[ほうし]}胞子{/r}が{r[ひさん]}飛散{/r}する。
GodInfo_God116	{r[もり]}森{/r}など{r[しっけ]}湿気{/r}の{r[おお]}多{/r}い{r[ばしょ]}場所{/r}が{r[す]}好{/r}き。\n{r[あたま]}頭{/r}のツノは、ベルの{r[おと]}音{/r}に{r[あ]}合{/r}わせて{r[ひか]}光{/r}りだす。
GodInfo_God118	ゴーレムの{r[すがた]}姿{/r}をとったスシガミ。\nにらめっこで{r[わら]}笑{/r}ったことは{r[いちど]}一度{/r}もない。
GodInfo_God119	{r[かいがん]}開眼{/r}した{r[ふしぎ]}不思議{/r}な{r[ひとみ]}瞳{/r}を{r[み]}見{/r}つめすぎてしまうと\n{r[よろこ]}喜{/r}びや{r[きぼう]}希望{/r}…{r[せい]}正{/r}の{r[かんじょう]}感情{/r}が{r[うば]}奪{/r}われてしまう…。
GodInfo_God121	オバケの{r[すがた]}姿{/r}をとったスシガミ。\n{r[たの]}楽{/r}しいことを{r[さが]}探{/r}して{r[つね]}常{/r}に{r[め]}目{/r}を{r[ひか]}光{/r}らせている。
GodInfo_God122	いつも{r[じょうきげん]}上機嫌{/r}で、ゴムボールのように\nボヨンボヨンと{r[は]}跳{/r}ねて{r[あそ]}遊{/r}んでいる。
GodInfo_God124	オバケの{r[すがた]}姿{/r}をとったスシガミ。\n{r[じごく]}地獄{/r}からの{r[ししゃ]}使者{/r}だぞ！と、{r[どうどう]}堂々{/r}と{r[うそ]}嘘{/r}をつく。
GodInfo_God125	まるで{r[どうけし]}道化師{/r}のように{r[ふ]}振{/r}る{r[ま]}舞{/r}う。{r[そうだい]}壮大{/r}な\n{r[つく]}作{/r}り{r[ばなし]}話{/r}をいくつも{r[も]}持{/r}ちネタにしている。
GodInfo_God127	ノームの{r[すがた]}姿{/r}をとったスシガミ。\nいかなる{r[とき]}時{/r}も、{r[ぼうし]}帽子{/r}のガードは{r[ゆる]}緩{/r}めない。
GodInfo_God128	{r[は]}葉{/r}を{r[つか]}使{/r}って{r[かぜ]}風{/r}を{r[の]}乗{/r}りこなす。{r[ゆた]}豊{/r}かなヒゲが\n{r[じまん]}自慢{/r}で、{r[まいにち]}毎日{/r}のお{r[てい]}手入{/r}れは{r[か]}欠{/r}かさない。
GodInfo_God130	バクの{r[すがた]}姿{/r}をとったスシガミ。\n{r[いねむ]}居眠{/r}りしていても、{r[かいわ]}会話{/r}ができるらしい…。
GodInfo_God131	{r[ひと]}人{/r}の{r[あくむ]}悪夢{/r}を{r[た]}食{/r}べることができる。\nまれに{r[きちむ]}吉夢{/r}も{r[た]}食{/r}べてしまうのは…ご{r[あいきょう]}愛嬌{/r}。
GodInfo_God133	プラズマの{r[すがた]}姿{/r}をとったスシガミ。\n{r[くろめがね]}黒眼鏡{/r}をクイっとするのは{r[じしんまんまん]}自信満々{/r}のとき。
GodInfo_God134	{r[じつ]}実{/r}はミュージシャン{r[きしつ]}気質{/r}。スシガミ、\nコンカンとセッションすることもある。
GodInfo_God136	タンポポの{r[すがた]}姿{/r}をとったスシガミ。\n{r[はな]}花{/r}びらからは、お{r[ひさま]}日様{/r}のにおいがする。
GodInfo_God137	{r[はる]}春{/r}が{r[す]}過{/r}ぎると、{r[はな]}花{/r}びらが{r[わたげ]}綿毛{/r}に{r[へんか]}変化{/r}して\nファンキーな{r[すがた]}姿{/r}になるらしい…。
GodInfo_God139	{r[ようせい]}妖精{/r}の{r[すがた]}姿{/r}をとったスシガミ。\nいたずら{r[ず]}好{/r}きなところがチャーミング。
GodInfo_God140	ドルカンのゼンマイを{r[はんたい]}反対{/r}に{r[まわ]}回{/r}したり、\nバクゾーの{r[まくら]}枕{/r}を{r[かく]}隠{/r}して{r[あそ]}遊{/r}んでいる。
GodInfo_God142	ワニの{r[すがた]}姿{/r}をとったスシガミ。\n{r[おお]}大{/r}きな{r[くち]}口{/r}で{r[いき]}息{/r}を{r[す]}吸{/r}うと{r[しゅうい]}周囲{/r}に{r[しんくう]}真空{/r}ができる。
GodInfo_God145	カラスの{r[すがた]}姿{/r}をとったスシガミ。\n{r[わるぢえ]}悪知恵{/r}は{r[はたら]}働{/r}くが、{r[こうどう]}行動{/r}に{r[うつ]}移{/r}す{r[ゆうき]}勇気{/r}はない…。
GodInfo_God146	{r[ゆうぐ]}夕暮{/r}れが{r[ちかづ]}近付{/r}くと、{r[も]}燃{/r}えるような{r[あつ]}熱{/r}い\nラブソングを{r[うた]}歌{/r}いたくなってしまう。
GodInfo_God148	{r[めいかい]}冥界{/r}の{r[かみ]}神{/r}の{r[すがた]}姿{/r}をとったスシガミ。\n{r[ほうたい]}包帯{/r}を{r[ま]}巻{/r}かせれば、{r[みぎ]}右{/r}に{r[で]}出{/r}る{r[もの]}者{/r}はいない。
GodInfo_GodC001	スシロー{r[じまとくゆう]}島特有{/r}のスシガミ？まぐろが{r[だいす]}大好{/r}き\nで{r[あかみ]}赤身{/r}のごとく{r[も]}燃{/r}える{r[じょうねつ]}情熱{/r}を{r[ひ]}秘{/r}めるという。
GodInfo_GodC002	スシロー{r[じまとくゆう]}島特有{/r}のスシガミ？てんこ{r[も]}盛{/r}りの\nいくらを、いつも{r[だ]}抱{/r}きしめ{r[つづ]}続{/r}けている。
GodInfo_GodC003	スシロー{r[じまとくゆう]}島特有{/r}のスシガミ？うにが{r[だいす]}大好{/r}き。\nうにを{r[だ]}抱{/r}いてほえる{r[すがた]}姿{/r}は{r[おうじゃ]}王者{/r}の{r[ふうかく]}風格{/r}をもつ。
GodInfo_GodC004	スシロー{r[じまとくゆう]}島特有{/r}のスシガミ？{r[とくぎ]}特技{/r}はバランの\n{r[しげ]}茂{/r}みからのジャンピングアタック。
GodInfo_GodC005	スシロー{r[じまとくゆう]}島特有{/r}のスシガミ？えびが{r[だいす]}大好{/r}き。\nプリプリでカワイイ{r[ところ]}所{/r}がお{r[き]}気{/r}に{r[い]}入{/r}りらしい。
GodInfo_GodC006	スシロー{r[じまとくゆう]}島特有{/r}のスシガミ？そのたまごは、\nもしや…？と{r[みなき]}皆気{/r}にしているが、{r[しんそう]}真相{/r}は…？
GodInfo_GodC007	スシロー{r[じまとくゆう]}島特有{/r}のスシガミ？{r[くま]}熊{/r}の{r[せんぱい]}先輩{/r}である\n「{r[さけ]}鮭{/r}をくわえた{r[きぼ]}木彫{/r}りの{r[くま]}熊{/r}」に{r[あこが]}憧{/r}れている。
GodInfo_GodC008	スシロー{r[じまとくゆう]}島特有{/r}のスシガミ？{r[き]}気{/r}に{r[い]}入{/r}らない{r[こと]}事{/r}が\nあるとネギを{r[しゅりけん]}手裏剣{/r}のように{r[な]}投{/r}げてくるらしい
GodInfo_GodC009	スシロー{r[じまとくゆう]}島特有{/r}のスシガミ？{r[ばつぐん]}抜群{/r}のバランス\n{r[かんかく]}感覚{/r}で、つぶつぶコーンを{r[きよう]}器用{/r}に{r[だ]}抱{/r}く。
GodInfo_GodC010	スシロー{r[じまとくゆう]}島特有{/r}のスシガミ？{r[おな]}同{/r}じカワイイ{r[けい]}系{/r}\nのえびウサギをライバル{r[し]}視{/r}しているという。
GodInfo_GodC011	スシロー{r[じまとくゆう]}島特有{/r}のスシガミ？{r[ひなた]}日向{/r}ぼっこ{r[ず]}好{/r}き\nだが、ネタが{r[かわ]}乾{/r}いてしまうのが{r[なや]}悩{/r}みらしい。
GodInfo_GodC012	スシロー{r[じまとくゆう]}島特有{/r}のスシガミ？あじが{r[だいす]}大好{/r}き。\n{r[しゅみ]}趣味{/r}はびちゃびちゃな{r[て]}手{/r}での{r[あくしゅ]}握手{/r}。
GodInfo_GodC013	スシロー{r[じまとくゆう]}島特有{/r}のスシガミ？ポテトはスシロ\nーのお{r[きゃくさま]}客様{/r}から{r[いっぽん]}１本{/r}ずつ{r[はいしゃく]}拝借{/r}した{r[もの]}物{/r}らしい。
\database\database_itemInfo.msbt
ItemInfo_Burner	スシガミに{r[つか]}使{/r}うと、{r[だ]}出{/r}せるスシの{r[なか]}中{/r}の\nひとつがあぶられてグレードアップする。\n{r[いちぶ]}一部{/r}のスシにのみ{r[ゆうこう]}有効{/r}。
ItemInfo_OhudaExpS	スシガミに{r[つか]}使{/r}うと、ちょっと{r[けいけんち]}経験値{/r}が\n{r[ふ]}増{/r}えるおふだ。どこかのスシガミの\n{r[にが]}苦{/r}い{r[けいけん]}経験{/r}が{r[ふう]}封{/r}じこめられている。
ItemInfo_OhudaExpM	スシガミに{r[つか]}使{/r}うと、わりと{r[けいけんち]}経験値{/r}が\n{r[ふ]}増{/r}えるおふだ。いろんなスシガミの\nあまずっぱい{r[けいけん]}経験{/r}が{r[ふう]}封{/r}じこめられている。
ItemInfo_OhudaExpL	スシガミに{r[つか]}使{/r}うと、すごく{r[けいけんち]}経験値{/r}が\n{r[ふ]}増{/r}えるおふだ。{r[おお]}多{/r}くのスシガミが{r[え]}得{/r}た\n{r[きょうくん]}教訓{/r}がまとめて{r[ふう]}封{/r}じこめられている。
ItemInfo_OhudaDefS	スシガミに{r[つか]}使{/r}うと、まもりのチカラが\nちょっと{r[ふ]}増{/r}えるおふだ。バルサ{r[ざい]}材{/r}が\n{r[つか]}使{/r}われており、やわらかい。
ItemInfo_OhudaDefM	スシガミに{r[つか]}使{/r}うと、まもりのチカラが\nわりと{r[ふ]}増{/r}えるおふだ。{r[すぎいた]}杉板{/r}が{r[つか]}使{/r}われて\nおり、{r[かお]}香{/r}りがよい。
ItemInfo_OhudaDefL	スシガミに{r[つか]}使{/r}うと、まもりのチカラが\nすごく{r[ふ]}増{/r}えるおふだ。メープル{r[ざい]}材{/r}が\n{r[つか]}使{/r}われており、{r[ひじょう]}非常{/r}にかたい。
ItemInfo_OhudaSkill	スシガミに{r[つか]}使{/r}うと、スキルレベルの\nメーターが{r[ふ]}増{/r}えるおふだ。{r[おお]}大{/r}スシガミ{r[さま]}様{/r}の\nパワーが{r[ふう]}封{/r}じこめられている。
ItemInfo_OhudaSkillC	スシガミに{r[つか]}使{/r}うと、スキルレベルの\nメーターがすごく{r[ふ]}増{/r}えるおふだ。\n{r[おお]}大{/r}スシガミ{r[さま]}様{/r}の{r[ちょう]}超{/r}パワーがあふれている。
ItemInfo_PlayerHpS	ムサシに{r[つか]}使{/r}うと、たいりょくが{r[すこ]}少{/r}し\n{r[あ]}上{/r}がるかんづめ。スタミナ{r[げん]}源{/r}となる\nカラい{r[まめ]}豆{/r}がつめこまれている。
ItemInfo_PlayerAtkS	ムサシに{r[つか]}使{/r}うと、うでっぷしが{r[すこ]}少{/r}し\n{r[あ]}上{/r}がるかんづめ。チカラがわいてくる\n{r[やさい]}野菜{/r}がつめこまれている。
ItemInfo_GearHero	スシを{r[ふか]}深{/r}く{r[あい]}愛{/r}する{r[もの]}者{/r}のみが{r[つか]}使{/r}える\nというレーンドライブギアの{r[なか]}中{/r}でも\nもっとも{r[つか]}使{/r}いやすい{r[ひょうじゅんてき]}標準的{/r}なギア。
ItemInfo_GearSuper	{r[ひょうじゅんてき]}標準的{/r}なスシライカーズギアの\n{r[きょうかばん]}強化版{/r}となるレーンドライブギア。\n{r[この]}好{/r}んで{r[つか]}使{/r}うスシライカーも{r[おお]}多{/r}い。
ItemInfo_GearHyper	スーパーギアよりもさらに{r[きょうりょく]}強力{/r}な\nレーンドライブギア。{r[つか]}使{/r}いこなすには\n{r[こうど]}高度{/r}なテクニックを{r[よう]}要{/r}する。
ItemInfo_GearUltimate	{r[きゅうきょく]}究極{/r}のレーンドライブギア。{r[ていこく]}帝国{/r}の\n{r[じっけん]}実験{/r}による{r[まもう]}摩耗{/r}で{r[しゅつりょく]}出力{/r}は{r[お]}落{/r}ちたが、\n{r[げんぞん]}現存{/r}のギアの{r[なか]}中{/r}ではもっとも{r[きょうりょく]}強力{/r}。
ItemInfo_GearStream	{r[かそく]}加速{/r}はゆっくりだが、{r[げんそく]}減速{/r}があまり\nなく、{r[かわ]}川{/r}のように{r[た]}絶{/r}え{r[ま]}間{/r}なく{r[なが]}流{/r}れ\n{r[つづ]}続{/r}けるのが{r[とくちょう]}特徴{/r}のレーンドライブギア。
ItemInfo_GearQuick	すばやい{r[かそく]}加速{/r}と、すばやい{r[げんそく]}減速{/r}が\n{r[とくちょう]}特徴{/r}で、ピンポイントでの{r[かつよう]}活用{/r}が\nできるレーンドライブギア。
ItemInfo_GearLittle	{r[ひょうじゅんてき]}標準的{/r}なスシライカーズギアよりも\nやや{r[しゅつりょく]}出力{/r}が{r[ひく]}低{/r}いレーンドライブギア。\nこちらを{r[つか]}使{/r}うスシライカーも{r[おお]}多{/r}い。
ItemInfo_ReadyRetryS	「じゅんびアイテム」として{r[も]}持{/r}って\nおくと、HPが０になった{r[とき]}時{/r}に{r[つか]}使{/r}われ、\nHPが{r[すこ]}少{/r}し{r[ふ]}増{/r}えて{r[ふっかつ]}復活{/r}できる。
ItemInfo_ReadyRetryM	「じゅんびアイテム」として{r[も]}持{/r}って\nおくと、HPが０になった{r[とき]}時{/r}に{r[つか]}使{/r}われ、\nHPが{r[はんぶん]}半分{/r}{r[ふ]}増{/r}えて{r[ふっかつ]}復活{/r}できる。
ItemInfo_ReadyRetryL	「じゅんびアイテム」として{r[も]}持{/r}って\nおくと、HPが０になった{r[とき]}時{/r}に{r[つか]}使{/r}われ、\nHPが{r[かんぜんかいふく]}完全回復{/r}して{r[ふっかつ]}復活{/r}できる。
ItemInfo_ReadyRetryC	「じゅんびアイテム」として{r[も]}持{/r}って\nおくと、HPが０になった{r[とき]}時{/r}に{r[つか]}使{/r}われ、\n{r[かんぜんかいふく]}完全回復{/r}＆{r[こうげきりょく]}攻撃力{/r}２{r[ばい]}倍{/r}で{r[ふっかつ]}復活{/r}できる。
ItemInfo_ScenarioSukajan	{r[おさな]}幼{/r}いころ、{r[ちち]}父{/r}からもらったもの。\nスシガミの{r[たましい]}魂{/r}を{r[ふう]}封{/r}じておくことができ、\nソデには{r[けいやくざら]}契約皿{/r}を{r[そうちゃく]}装着{/r}できる。
ItemInfo_ScenarioDictionary	{r[ここんとうざい]}古今東西{/r}のスシガミやスシの{r[じょうほう]}情報{/r}が\nまとめられた{r[ふる]}古{/r}い{r[しょもつ]}書物{/r}。{r[けいやく]}契約{/r}のたびに\n{r[ないよう]}内容{/r}が{r[か]}書{/r}き{r[た]}足{/r}されていく。
ItemInfo_ScenarioHelp	スシバトルの{r[おうぎ]}奥義{/r}がつめこまれた\nスシライカー{r[ひっけい]}必携{/r}の{r[しょ]}書{/r}。バトルで\n{r[たっせい]}達成{/r}した{r[いぎょう]}偉業{/r}も{r[きろく]}記録{/r}されていく。
ItemInfo_ScenarioKey01	アブリコスが{r[も]}持{/r}っていたカギ。\nおそらく{r[ていこく]}帝国{/r}の{r[じゅうようしせつ]}重要施設{/r}に{r[かか]}関{/r}わる\nものと{r[おも]}思{/r}われる。
ItemInfo_ScenarioKey02	バンブークが{r[も]}持{/r}っていたカギ。\nおそらく{r[ていこく]}帝国{/r}の{r[じゅうようしせつ]}重要施設{/r}に{r[かか]}関{/r}わる\nものと{r[おも]}思{/r}われる。
ItemInfo_ScenarioKey03	ソスナが{r[も]}持{/r}っていたカギ。\nおそらく{r[ていこく]}帝国{/r}の{r[じゅうようしせつ]}重要施設{/r}に{r[かか]}関{/r}わる\nものと{r[おも]}思{/r}われる。
ItemInfo_Stone	{r[うみ]}海{/r}の{r[ちか]}近{/r}くの{r[とち]}土地{/r}でたまに{r[と]}取{/r}れる\n{r[きみょう]}奇妙{/r}な{r[かたち]}形{/r}の{r[いし]}石{/r}。{r[うみ]}海{/r}に{r[かんけい]}関係{/r}する{r[なに]}何{/r}かが\n{r[いし]}石{/r}になったものと{r[い]}言{/r}われている。
ItemInfo_StoneBig	{r[うみ]}海{/r}の{r[ちか]}近{/r}くでまれに{r[み]}見{/r}つかる{r[えんけい]}円形{/r}の\n{r[きみょう]}奇妙{/r}な{r[いし]}石{/r}。レーンドライブギアの{r[ざいりょう]}材料{/r}\nだが、ここまで{r[おお]}大{/r}きい{r[もの]}物{/r}は{r[きしょう]}希少{/r}。
ItemInfo_OhudaPT	スシガミのテンションを{r[あ]}上{/r}げて、\n{r[おおぜい]}大勢{/r}にスシをふるまえるおふだ。\nチビっこハウスで{r[つか]}使{/r}える。
ItemInfo_LimitOverScore	「じゅんびアイテム」として{r[も]}持{/r}って\nおくと、バトルで{r[さいだい]}最大{/r}HPが{r[はんぶん]}半分{/r}になるが\nスコアが1.5{r[ばい]}倍{/r}になる。ずっと{r[つか]}使{/r}える。
ItemInfo_ResearchDoc	{r[ひょうし]}表紙{/r}に{r[おお]}大{/r}きく「{r[じんこう]}人工{/r}スシゲート{r[けいかく]}計画{/r}」と\n{r[か]}書{/r}かれた{r[しりょう]}資料{/r}。{r[かそくき]}加速器{/r}を{r[つか]}使{/r}い{r[にんげん]}人間{/r}の{r[て]}手{/r}で\nスシゲートを{r[ひら]}開{/r}くための{r[ひみつけんきゅう]}秘密研究{/r}らしい。
ItemInfo_ContractDish00	「じゅんびアイテム」として{r[も]}持{/r}ち、\nイイ{r[たたか]}戦{/r}いをするとスシガミが{r[あらわ]}現{/r}れる…!?\nスシライカーランク２{r[だん]}段{/r}から{r[けいやくかのう]}契約可能{/r}。
ItemInfo_ContractDish01	「じゅんびアイテム」として{r[も]}持{/r}ち、\nイイ{r[たたか]}戦{/r}いをするとカズラサツが{r[あらわ]}現{/r}れる!?\nスシライカーランク４{r[だん]}段{/r}から{r[けいやくかのう]}契約可能{/r}。
ItemInfo_ContractDish02	「じゅんびアイテム」として{r[も]}持{/r}ち、\nイイ{r[たたか]}戦{/r}いをするとゴレカンが{r[あらわ]}現{/r}れる!?\nスシライカーランク３{r[だん]}段{/r}から{r[けいやくかのう]}契約可能{/r}。
ItemInfo_ContractDish03	「じゅんびアイテム」として{r[も]}持{/r}ち、\nイイ{r[たたか]}戦{/r}いをするとクロカンが{r[あらわ]}現{/r}れる!?\nスシライカーランク５{r[だん]}段{/r}から{r[けいやくかのう]}契約可能{/r}。
ItemInfo_ContractDish04	「じゅんびアイテム」として{r[も]}持{/r}ち、\nイイ{r[たたか]}戦{/r}いをするとガロオウが{r[あらわ]}現{/r}れる!?\nスシライカーランク７{r[だん]}段{/r}から{r[けいやくかのう]}契約可能{/r}。
ItemInfo_ContractDish05	「じゅんびアイテム」として{r[も]}持{/r}ち、\nイイ{r[たたか]}戦{/r}いをするとスシガミが{r[あらわ]}現{/r}れる…!?\nスシライカーランク２{r[だん]}段{/r}から{r[けいやくかのう]}契約可能{/r}。
ItemInfo_ContractDish06	「じゅんびアイテム」として{r[も]}持{/r}ち、\nイイ{r[たたか]}戦{/r}いをするとキャッテンが{r[あらわ]}現{/r}れる!?\nスシライカーランク２{r[だん]}段{/r}から{r[けいやくかのう]}契約可能{/r}。
ItemInfo_ContractDish07	「じゅんびアイテム」として{r[も]}持{/r}ち、\nイイ{r[たたか]}戦{/r}いをするとオルテンが{r[あらわ]}現{/r}れる…!?\nスシライカーランク７{r[だん]}段{/r}から{r[けいやくかのう]}契約可能{/r}。
ItemInfo_ContractDish08	「じゅんびアイテム」として{r[も]}持{/r}ち、\nイイ{r[たたか]}戦{/r}いをするとスイテンが{r[あらわ]}現{/r}れる…!?\nスシライカーランク２{r[だん]}段{/r}から{r[けいやくかのう]}契約可能{/r}。
ItemInfo_ContractDish09	「じゅんびアイテム」として{r[も]}持{/r}ち、\nイイ{r[たたか]}戦{/r}いをするとボンテンが{r[あらわ]}現{/r}れる…!?\nスシライカーランク８{r[だん]}段{/r}から{r[けいやくかのう]}契約可能{/r}。
ItemInfo_ContractDish10	「じゅんびアイテム」として{r[も]}持{/r}ち、\nイイ{r[たたか]}戦{/r}いをするとバッテンが{r[あらわ]}現{/r}れる…!?\nスシライカーランク６{r[だん]}段{/r}から{r[けいやくかのう]}契約可能{/r}。
ItemInfo_ContractDish11	「じゅんびアイテム」として{r[も]}持{/r}ち、\nイイ{r[たたか]}戦{/r}いをするとフェアテンが{r[あらわ]}現{/r}れる!?\nスシライカーランク２{r[だん]}段{/r}から{r[けいやくかのう]}契約可能{/r}。
ItemInfo_ContractDish12	「じゅんびアイテム」として{r[も]}持{/r}ち、\nイイ{r[たたか]}戦{/r}いをするとホウテンが{r[あらわ]}現{/r}れる…!?\nスシライカーランク３{r[だん]}段{/r}から{r[けいやくかのう]}契約可能{/r}。
ItemInfo_CollaboItem01	スシロー{r[じま]}島{/r}エリアのまぐろラッコが{r[きねん]}記念{/r}の\n{r[しな]}品{/r}としてくれたスシネタ。{r[おお]}大{/r}きくて{r[じょうしつ]}上質{/r}。\nムサシが{r[た]}食{/r}べると、うでっぷしが{r[あ]}上{/r}がる。
ItemInfo_CollaboItem02	スシガミに{r[つか]}使{/r}うと、ものすごく{r[けいけんち]}経験値{/r}が\n{r[ふ]}増{/r}えるおふだ。おいしいスシを{r[ていきょう]}提供{/r}する\nための{r[なが]}長{/r}い{r[けいけん]}経験{/r}が{r[ふう]}封{/r}じこめられている。
ItemInfo_CollaboItem03	スシガミに{r[つか]}使{/r}うと、まもりのチカラが\nものすごく{r[ふ]}増{/r}えるおまもり。{r[むかし]}昔{/r}のスシ{r[おけ]}桶{/r}\nでできており、{r[あまず]}甘酸{/r}っぱい{r[かお]}香{/r}りがする。
\database\database_stage.msbt
stageName_stage001	{r[こっきょう]}国境{/r}への{r[みち]}道{/r}１
stageName_stage002	{r[こっきょう]}国境{/r}への{r[みち]}道{/r}２
stageName_stage003	{r[こっきょう]}国境{/r}への{r[みち]}道{/r}３
stageName_stage004	{r[こっきょう]}国境{/r}への{r[みち]}道{/r}４
stageName_stage005	{r[こっきょう]}国境{/r}への{r[みち]}道{/r}５
stageName_stage006	{r[こっきょう]}国境{/r}への{r[みち]}道{/r}６
stageName_stage007	{r[こっきょう]}国境{/r}への{r[みち]}道{/r}７
stageName_stage008	スシ{r[かいほうせんせん]}解放戦線{/r}アジト
stageName_stage009	{r[ちんじゅ]}鎮守{/r}の{r[もり]}森{/r}への{r[みち]}道{/r}１
stageName_stage010	{r[ちんじゅ]}鎮守{/r}の{r[もり]}森{/r}への{r[みち]}道{/r}２
stageName_stage011	{r[ちんじゅ]}鎮守{/r}の{r[もり]}森{/r}への{r[みち]}道{/r}３
stageName_stage012	{r[ちんじゅ]}鎮守{/r}の{r[もり]}森{/r}への{r[みち]}道{/r}４
stageName_stage013	{r[ちんじゅ]}鎮守{/r}の{r[もり]}森{/r}への{r[みち]}道{/r}５
stageName_stage014	{r[ちんじゅ]}鎮守{/r}の{r[もり]}森{/r}への{r[みち]}道{/r}６
stageName_stage015	{r[ちんじゅ]}鎮守{/r}の{r[もり]}森{/r}への{r[みち]}道{/r}７
stageName_stage016	{r[ちんじゅ]}鎮守{/r}の{r[もり]}森{/r}への{r[みち]}道{/r}８
stageName_stage017	{r[ちんじゅ]}鎮守{/r}の{r[もり]}森{/r}への{r[みち]}道{/r}９
stageName_stage018	{r[ちんじゅ]}鎮守{/r}の{r[もり]}森{/r}ゲート{r[まえ]}前{/r}
stageName_stage019	{r[ちんじゅ]}鎮守{/r}の{r[もり]}森{/r}ゲート
stageName_stage020	{r[こっきょう]}国境{/r}ゲートへの{r[みち]}道{/r}１
stageName_stage021	{r[こっきょう]}国境{/r}ゲートへの{r[みち]}道{/r}２
stageName_stage022	{r[こっきょう]}国境{/r}ゲートへの{r[みち]}道{/r}３
stageName_stage023	{r[こっきょう]}国境{/r}ゲートへの{r[みち]}道{/r}４
stageName_stage024	{r[こっきょう]}国境{/r}ゲートへの{r[みち]}道{/r}５
stageName_stage025	{r[てんぼうのはら]}展望野原{/r}
stageName_stage026	{r[こっきょう]}国境{/r}ゲートへの{r[みち]}道{/r}６
stageName_stage027	{r[こっきょう]}国境{/r}ゲートへの{r[みち]}道{/r}７
stageName_stage028	{r[こっきょうだい]}国境第{/r}１ゲート{r[まえ]}前{/r}
stageName_stage029	{r[こっきょうだい]}国境第{/r}１ゲート
stageName_stage030	{r[こっきょうだい]}国境第{/r}２ゲート
stageName_stage031	{r[こっきょうさいしゅう]}国境最終{/r}ゲート{r[まえ]}前{/r}
stageName_stage032	{r[はまべ]}浜辺{/r}への{r[みち]}道{/r}１
stageName_stage033	{r[はまべ]}浜辺{/r}への{r[みち]}道{/r}２
stageName_stage034	{r[はまべ]}浜辺{/r}への{r[みち]}道{/r}３
stageName_stage035	{r[はまべ]}浜辺{/r}への{r[みち]}道{/r}４
stageName_stage036	{r[はまべ]}浜辺{/r}への{r[みち]}道{/r}５
stageName_stage037	ウッドデッキ
stageName_stage038	{r[はまべ]}浜辺{/r}への{r[みち]}道{/r}６
stageName_stage039	{r[はまべ]}浜辺{/r}への{r[みち]}道{/r}７
stageName_stage040	{r[はまべ]}浜辺{/r}への{r[みち]}道{/r}８
stageName_stage041	{r[はまべ]}浜辺{/r}への{r[みち]}道{/r}９
stageName_stage042	{r[はまべ]}浜辺{/r}１
stageName_stage043	{r[はまべ]}浜辺{/r}２
stageName_stage044	{r[はまべ]}浜辺{/r}３
stageName_stage045	{r[かいじょうきちつうろ]}海上基地通路{/r}１
stageName_stage046	{r[かいじょうきちつうろ]}海上基地通路{/r}２
stageName_stage047	{r[かいじょうきちつうろ]}海上基地通路{/r}３
stageName_stage048	{r[かいじょうきちつうろ]}海上基地通路{/r}４
stageName_stage049	{r[かいじょうきちつうろ]}海上基地通路{/r}５
stageName_stage050	{r[かいじょうきちつうろ]}海上基地通路{/r}６
stageName_stage051	{r[しょうぐん　　]}将軍{/r}の{r[　とりでまえ]}砦前{/r}
stageName_stage052	{r[しょうぐん　]}将軍{/r}の{r[　とりで]}砦{/r}
stageName_stage053	{r[こうえき]}交易{/r}の{r[まち]}町{/r}バラン１
stageName_stage054	{r[こうえき]}交易{/r}の{r[まち]}町{/r}バラン２
stageName_stage055	{r[こうえき]}交易{/r}の{r[まち]}町{/r}バラン３
stageName_stage056	{r[こうえき]}交易{/r}の{r[まち]}町{/r}バラン４
stageName_stage057	{r[こうえき]}交易{/r}の{r[まち]}町{/r}バラン５
stageName_stage058	{r[こうえき]}交易{/r}の{r[まち]}町{/r}バラン６
stageName_stage059	{r[こうえき]}交易{/r}の{r[まち]}町{/r}バラン７
stageName_stage060	{r[こくそうちたい]}穀倉地帯{/r}１
stageName_stage061	{r[こくそうちたい]}穀倉地帯{/r}２
stageName_stage062	{r[ようさい]}要塞{/r}ナバ・{r[せいもん]}正門{/r}
stageName_stage063	{r[ようさい]}要塞{/r}ナバ・{r[くるわ]}郭{/r}１
stageName_stage064	{r[ようさい]}要塞{/r}ナバ・{r[くるわ]}郭{/r}２
stageName_stage065	{r[ようさい]}要塞{/r}ナバ・{r[くるわ]}郭{/r}３
stageName_stage066	{r[ようさい]}要塞{/r}ナバ・{r[くるわ]}郭{/r}４
stageName_stage067	{r[ようさい]}要塞{/r}ナバ・{r[うちもん]}内門{/r}
stageName_stage068	{r[ようさい]}要塞{/r}ナバ・{r[とりで]}砦{/r}１
stageName_stage069	{r[ようさい]}要塞{/r}ナバ・{r[とりで]}砦{/r}２
stageName_stage070	{r[ようさい]}要塞{/r}ナバ・{r[とりで]}砦{/r}３
stageName_stage071	{r[ようさい]}要塞{/r}ナバ・{r[とりで]}砦{/r}４
stageName_stage072	{r[ようさい]}要塞{/r}ナバ・はね{r[ばしまえ]}橋前{/r}
stageName_stage073	{r[やえい]}野営{/r}キャンプ
stageName_stage074	{r[ばいてん]}売店{/r}エリア１
stageName_stage075	{r[ばいてん]}売店{/r}エリア２
stageName_stage076	{r[ばいてん]}売店{/r}エリア３
stageName_stage077	{r[ばいてん]}売店{/r}エリア４
stageName_stage078	{r[とざん]}登山{/r}ルート１
stageName_stage079	{r[とざん]}登山{/r}ルート２
stageName_stage080	{r[とざん]}登山{/r}ルート３
stageName_stage081	{r[とざん]}登山{/r}ルート４
stageName_stage082	{r[とざん]}登山{/r}ルート５
stageName_stage083	{r[とざん]}登山{/r}ルート６
stageName_stage084	{r[とざん]}登山{/r}ルート７
stageName_stage085	{r[とざん]}登山{/r}ルート８
stageName_stage086	{r[とざん]}登山{/r}ルート９
stageName_stage087	{r[めいしょ]}名所{/r}・{r[ようがんたき]}溶岩滝{/r}
stageName_stage088	{r[こうざんとりで]}鉱山砦{/r}への{r[みち]}道{/r}１
stageName_stage089	{r[こうざんとりで]}鉱山砦{/r}への{r[みち]}道{/r}２
stageName_stage090	{r[こうざんとりで]}鉱山砦{/r}への{r[みち]}道{/r}３
stageName_stage091	{r[こうざんとりで]}鉱山砦{/r}への{r[みち]}道{/r}４
stageName_stage092	{r[こうざんとりで]}鉱山砦{/r}への{r[みち]}道{/r}５
stageName_stage093	{r[こうざんとりで]}鉱山砦{/r}への{r[みち]}道{/r}６
stageName_stage094	ソスナの{r[こうざんとりで]}鉱山砦{/r}
stageName_stage095	{r[りっかさん]}六花山{/r}・{r[とざんどう]}登山道{/r}１
stageName_stage096	{r[りっかさん]}六花山{/r}・{r[とざんどう]}登山道{/r}２
stageName_stage097	{r[りっかさん]}六花山{/r}・{r[とざんどう]}登山道{/r}３
stageName_stage098	{r[りっかさん]}六花山{/r}・{r[とざんどう]}登山道{/r}４
stageName_stage099	{r[りっかさん]}六花山{/r}・{r[とりで]}砦{/r}
stageName_stage100	{r[りっかさん]}六花山{/r}・{r[げざんどう]}下山道{/r}１
stageName_stage101	{r[りっかさん]}六花山{/r}・{r[げざんどう]}下山道{/r}２
stageName_stage102	{r[りっかさん]}六花山{/r}・{r[げざんどう]}下山道{/r}３
stageName_stage103	{r[りっかさん]}六花山{/r}・{r[ふな]}船{/r}つき{r[ば]}場{/r}
stageName_stage104	{r[さいくんれんしせつ]}再訓練施設{/r}・{r[せいもん]}正門{/r}
stageName_stage105	{r[くんれんとう]}訓練棟{/r}
stageName_stage106	{r[さいくんれんしせつ]}再訓練施設{/r}・{r[つうろ]}通路{/r}１
stageName_stage107	{r[さいくんれんしせつ]}再訓練施設{/r}・{r[つうろ]}通路{/r}２
stageName_stage108	{r[さいくんれんしせつ]}再訓練施設{/r}・{r[つうろ]}通路{/r}３
stageName_stage109	{r[さいくんれんしせつ]}再訓練施設{/r}・{r[つうろ]}通路{/r}４
stageName_stage110	{r[とくべつくんれんとう]}特別訓練棟{/r}
stageName_stage111	{r[さいくんれんしせつ]}再訓練施設{/r}・{r[うらもん]}裏門{/r}
stageName_stage112	{r[ていこくかいどう]}帝国街道{/r}１
stageName_stage113	{r[ていこくかいどう]}帝国街道{/r}２
stageName_stage114	{r[ていこくかいどう]}帝国街道{/r}３
stageName_stage115	{r[ていこくかいどう]}帝国街道{/r}４
stageName_stage116	{r[ていこくかいどう]}帝国街道{/r}５
stageName_stage117	{r[ていこくかいどう]}帝国街道{/r}６
stageName_stage118	{r[ていこくかいどう]}帝国街道{/r}７
stageName_stage119	{r[ていこくかいどう]}帝国街道{/r}８
stageName_stage120	{r[ていこくかいどう]}帝国街道{/r}９
stageName_stage121	{r[ていと]}帝都{/r}・{r[せいもん]}正門{/r}
stageName_stage122	{r[ていと]}帝都{/r}１
stageName_stage123	{r[ていと]}帝都{/r}２
stageName_stage124	{r[ていと]}帝都{/r}３
stageName_stage125	{r[ていと]}帝都{/r}４
stageName_stage126	{r[ていと]}帝都{/r}５
stageName_stage127	{r[ていと]}帝都{/r}６
stageName_stage128	{r[ていと]}帝都{/r}７
stageName_stage129	{r[ていと]}帝都{/r}８
stageName_stage130	{r[きゅうでんじょうもん]}宮殿城門{/r}
stageName_stage131	{r[きゅうでんいりぐち]}宮殿入口{/r}
stageName_stage132	エントランス１
stageName_stage133	エントランス２
stageName_stage134	エントランス３
stageName_stage135	エントランス４
stageName_stage136	{r[きゅうでんろうか]}宮殿廊下{/r}
stageName_stage137	{r[へいしつめしょ]}兵士詰所{/r}１
stageName_stage138	{r[へいしつめしょ]}兵士詰所{/r}２
stageName_stage139	{r[へいしつめしょ]}兵士詰所{/r}３
stageName_stage140	{r[へいしつめしょ]}兵士詰所{/r}４
stageName_stage141	{r[してんのう]}四天王{/r}の{r[ま]}間{/r}１
stageName_stage142	{r[してんのう]}四天王{/r}の{r[ま]}間{/r}２
stageName_stage143	{r[してんのう]}四天王{/r}の{r[ま]}間{/r}３
stageName_stage144	{r[してんのう]}四天王{/r}の{r[ま]}間{/r}４
stageName_stage145	{r[こうてい]}皇帝{/r}の{r[ま]}間{/r}
stageName_stage146	{r[こうてい]}皇帝{/r}の{r[ま]}間{/r}・{r[ぎょくざ]}玉座{/r}
stageName_area01_ex001	かくしステージ１
stageName_area01_ex002	かくしステージ２
stageName_area01_ex003	かくしステージ３
stageName_area01_ex004	{r[みさき]}岬{/r}のかくれほこら
stageName_area02_ex001	かくしステージ１
stageName_area02_ex002	かくしステージ２
stageName_area02_ex003	かくしステージ３
stageName_area02_ex004	{r[かいがん]}海岸{/r}のかくれほこら
stageName_area03_ex001	かくしステージ１
stageName_area03_ex002	かくしステージ２
stageName_area03_ex003	かくしステージ３
stageName_area03_ex004	かくしステージ４
stageName_area03_ex005	かくしステージ５
stageName_area03_ex006	かくしステージ６
stageName_area03_ex007	かくしステージ７
stageName_area03_ex008	{r[こうざん]}鉱山{/r}のかくれほこら
stageName_area04_ex001	かくしステージ１
stageName_area04_ex002	かくしステージ２
stageName_area04_ex003	かくしステージ３
stageName_area04_ex004	{r[ようさい]}要塞{/r}のかくれほこら
stageName_area05_ex001	かくしステージ１
stageName_area05_ex002	かくしステージ２
stageName_area05_ex003	かくしステージ３
stageName_area05_ex004	{r[ことう]}孤島{/r}のかくれほこら
stageName_area06_ex001	かくしステージ１
stageName_area06_ex002	かくしステージ２
stageName_area06_ex003	かくしステージ３
stageName_area06_ex004	かくしステージ４
stageName_area06_ex005	かくしステージ５
stageName_area06_ex006	かくしステージ６
stageName_area06_ex007	かくしステージ７
stageName_area06_ex008	かくしステージ８
stageName_area06_ex009	かくしステージ９
stageName_area06_ex010	{r[きた]}北{/r}の{r[もり]}森{/r}のかくれほこら
stageName_area07_ex001	{r[しょうぞうが]}肖像画{/r}
stageName_area04sub_001	{r[おくち]}奥地{/r}の{r[みち]}道{/r}１
stageName_area04sub_002	{r[おくち]}奥地{/r}の{r[みち]}道{/r}２
stageName_area04sub_003	{r[おくち]}奥地{/r}の{r[みち]}道{/r}３
stageName_area04sub_004	{r[おくち]}奥地{/r}の{r[みち]}道{/r}４
stageName_area04sub_005	{r[おくち]}奥地{/r}の{r[みち]}道{/r}５
stageName_area04sub_006	{r[おくち]}奥地{/r}の{r[みち]}道{/r}６
stageName_area04sub_007	{r[おくち]}奥地{/r}の{r[みち]}道{/r}７
stageName_area04sub_008	{r[おくち]}奥地{/r}の{r[みち]}道{/r}８
stageName_area04sub_009	{r[おくち]}奥地{/r}の{r[みち]}道{/r}９
stageName_area04sub_010	{r[おくち]}奥地{/r}のかくれ{r[じんじゃ]}神社{/r}
stageName_area04sub_ex001	かくしステージ１
stageName_area04sub_ex002	{r[ゆきやま]}雪山{/r}のかくれほこら
stageName_area06sub_001	{r[みなみ]}南{/r}の{r[かいどう]}街道{/r}１
stageName_area06sub_002	{r[みなみ]}南{/r}の{r[かいどう]}街道{/r}２
stageName_area06sub_003	{r[みなみ]}南{/r}の{r[かいどう]}街道{/r}３
stageName_area06sub_004	{r[みなみ]}南{/r}の{r[かいどう]}街道{/r}４
stageName_area06sub_005	{r[みなみ]}南{/r}の{r[かいどう]}街道{/r}５
stageName_area06sub_006	{r[みなみ]}南{/r}の{r[かいどう]}街道{/r}６
stageName_area06sub_007	{r[みなみ]}南{/r}の{r[かいどう]}街道{/r}７
stageName_area06sub_008	{r[みなみ]}南{/r}の{r[かいどう]}街道{/r}８
stageName_area06sub_009	{r[みなみ]}南{/r}の{r[かいどう]}街道{/r}９
stageName_area06sub_010	{r[ていこくぐんちかしせつ]}帝国軍地下施設{/r}
stageName_area06sub_ex001	かくしステージ１
stageName_area06sub_ex002	{r[みなみ]}南{/r}のかくれほこら
stageName_area08_001	{r[なぞ]}謎{/r}の{r[しせつまえ]}施設前{/r}
stageName_area08_002	パラレルゲート No.1/31
stageName_area08_003	パラレルゲート No.2/31
stageName_area08_004	パラレルゲート No.3/31
stageName_area08_005	パラレルゲート No.4/31
stageName_area08_006	パラレルゲート No.5/31
stageName_area08_007	パラレルゲート No.6/31
stageName_area08_008	パラレルゲート No.7/31
stageName_area08_009	パラレルゲート No.8/31
stageName_area08_010	パラレルゲート No.9/31
stageName_area08_011	パラレルゲート No.10/31
stageName_area08_012	パラレルゲート No.11/31
stageName_area08_013	パラレルゲート No.12/31
stageName_area08_014	パラレルゲート No.13/31
stageName_area08_015	パラレルゲート No.14/31
stageName_area08_016	パラレルゲート No.15/31
stageName_area08_017	パラレルゲート No.16/31
stageName_area08_018	パラレルゲート No.17/31
stageName_area08_019	パラレルゲート No.18/31
stageName_area08_020	パラレルゲート No.19/31
stageName_area08_021	パラレルゲート No.20/31
stageName_area08_022	パラレルゲート No.21/31
stageName_area08_023	パラレルゲート No.22/31
stageName_area08_024	パラレルゲート No.23/31
stageName_area08_025	パラレルゲート No.24/31
stageName_area08_026	パラレルゲート No.25/31
stageName_area08_027	パラレルゲート No.26/31
stageName_area08_028	パラレルゲート No.27/31
stageName_area08_029	パラレルゲート No.28/31
stageName_area08_030	パラレルゲート No.29/31
stageName_area08_031	パラレルゲート No.30/31
stageName_area08_032	パラレルゲート No.31/31
stageName_area50_001	おさら{r[じま]}島{/r}１
stageName_area50_002	{r[だいいち]}第一{/r}おはし{r[ばし]}橋{/r}１
stageName_area50_003	{r[だいいち]}第一{/r}おはし{r[ばし]}橋{/r}２
stageName_area50_004	おさら{r[じま]}島{/r}２
stageName_area50_005	おさら{r[じま]}島{/r}２スシロー{r[まえ]}前{/r}
stageName_area50_006	{r[だいに]}第二{/r}おはし{r[ばし]}橋{/r}１
stageName_area50_007	{r[だいに]}第二{/r}おはし{r[ばし]}橋{/r}２
stageName_area50_008	{r[だいに]}第二{/r}おはし{r[ばし]}橋{/r}３
stageName_area50_009	おしょう{r[ゆ]}湯{/r}
stageName_area50_010	{r[だいさん]}第三{/r}おはし{r[ばし]}橋{/r}１
stageName_area50_011	{r[だいさん]}第三{/r}おはし{r[ばし]}橋{/r}２
stageName_area50_012	おさら{r[じま]}島{/r}３
stageName_area50_013	おさら{r[じま]}島{/r}３わさび{r[やま]}山{/r}ふもと
stageName_area50_014	{r[だいよん]}第四{/r}おはし{r[ばし]}橋{/r}１
stageName_area50_015	{r[だいよん]}第四{/r}おはし{r[ばし]}橋{/r}２
stageName_area50_016	おさら{r[じま]}島{/r}４スシロー{r[まえ]}前{/r}
stageName_area50_017	{r[だいご]}第五{/r}おはし{r[ばし]}橋{/r}１
stageName_area50_018	{r[だいご]}第五{/r}おはし{r[ばし]}橋{/r}２
stageName_area50_019	{r[だいご]}第五{/r}おはし{r[ばし]}橋{/r}３
stageName_area50_020	まんぷく{r[じま]}島{/r}ガリ{r[いわ]}岩{/r}
stageName_area50_ex001	おさら{r[じま]}島{/r}５
stageName_area50_ex002	すぷーん{r[ばし]}橋{/r}１
stageName_area50_ex003	すぷーん{r[ばし]}橋{/r}２
stageName_area50_ex004	すぷーん{r[ばし]}橋{/r}３
stageName_area50_ex005	おさら{r[じま]}島{/r}６
\event\episode_cmn.msbt
System_Label_MaskLower_M	Ａボタンまたは{r[したがめん]}下画面{/r}タッチで{r[すす]}進{/r}みます
Name_Label_Musashi_M	ムサシ
Name_Label_Salmon_M	ジンライ
Name_Label_Leo_M	ジンライ
Name_Label_Kojiro_M	コジロー
Name_Label_Yukichi_M	ユキチ
Name_Label_Ryoma_M	リョーマ
Name_Label_Yuulia_M	ユーリア
Name_Label_Amaebi_M	アラオウ
Name_Label_Sweats_M	ペンゾー
Name_Label_Myway_M	ゴクオウ
Name_Label_Rob_M	カズラサツ
Name_Label_Superstar_M	マウソー
Name_Label_Lanelow_M	ポポカン
Name_Label_Blind_M	ゴレカン
Name_Label_Hpchange_M	アヌビサツ
Name_Label_Invisible_M	クロカン
Name_Label_Reflection_M	ガロオウ
Name_Label_Skillcopy_M	カメレサツ
Name_Label_Vacuum_M	ワニオウ
Name_Label_LaneFill_M	キャッテン
Name_Label_Doton_M	ドートン
Name_Label_Ablicos_M	アブリコス
Name_Label_Bamboo_M	バンブーク
Name_Label_Sosuna_M	ソスナ
Name_Label_Grohm_M	グロム
Name_Label_Glado_M	グラード
Name_Label_Chara_M	チャラオ
Name_Label_Father_M	ジュウベエ
Name_Label_EmpireCommander_M	タイチョウ
Name_Label_EmpireCommander2_M	シレイカン
Name_Label_EmpirePrivate_M	テイコクヘイ
Name_Label_LiberionSoldier_M	ギユウヘイ
Name_Label_LiberionSoldierPlu_M	ギユウヘイ
Name_Label_KidsVi_M	こどもたち
Name_Label_KidsBe_M	こどもたち
Name_Label_KidsVo_M	こどもたち
Name_Label_SolAb_M	テイコクヘイ
Name_Label_ComAb_M	タイチョウ
Name_Label_SolBa_M	テイコクヘイ
Name_Label_ComBa_M	タイチョウ
Name_Label_SolSo_M	テイコクヘイ
Name_Label_ComSo_M	タイチョウ
Name_Label_SolGr_M	テイコクヘイ
Name_Label_ComGr_M	タイチョウ
Name_Label_ComRo_M	シュリョウ
Name_Label_Unknown_M	？？？
Name_Label_Priest_M	ミコ
Name_Label_Engineer_M	ギシ
BossEntryLabelGeneral_Abricos	{r[しょうぐん]}将軍{/r}アブリコス
BossEntryLabelGeneral_Bambooque	{r[しょうぐん]}将軍{/r}バンブーク
BossEntryLabelGeneral_Sosuna	{r[しょうぐん]}将軍{/r}ソスナ
BossEntryLabelEntry_M	{r[とうじょう]}登場{/r}！！！！
BuildUpLevel2_M	たてものLV2にアップ！！
BuildUpLevel3_M	たてものLV3にアップ！！
Name_Label_ComRoAl_M	ボス
\event\stageBattleArea50_001.msbt
CharaSerif_00_M	なっ、なんだ!?\nHPが{r[さいしょ]}最初{/r}からだいぶ{r[すく]}少{/r}なかったぞ！
CharaSerif_00_F	なっ、なに!?\nHPが{r[さいしょ]}最初{/r}からだいぶ{r[すく]}少{/r}なくなかった？
CharaSerif_01_M	そうか･･･ いつものスシガミたちとは{r[ちが]}違{/r}うもんな。\nこりゃ、いきなり{r[だい]}大{/r}ピンチかも･･･？
CharaSerif_01_F	そうか･･･ いつものスシガミたちとは{r[ちが]}違{/r}うもんね。\nこれは、いきなり{r[だい]}大{/r}ピンチかも･･･
CharaSerif_02_M	･･･えっ、このアイテム？\nこれを{r[た]}食{/r}べれば、{c[ffae00]}{r[かいふく]}回復{/r}{c[000000]}できるのか？
CharaSerif_02_F	･･･えっ、このアイテム？\nこれを{r[た]}食{/r}べれば、{c[ffae00]}{r[かいふく]}回復{/r}{c[000000]}できるの？
CharaSerif_03_M	わかった！ {r[で]}出{/r}たらソッコーで{r[と]}取{/r}るよ！\nたよりにしてるぜ!!
CharaSerif_03_F	わかった！ {r[で]}出{/r}たら{r[いそ]}急{/r}いで{r[と]}取{/r}るわ！\nたよりにしてるわね!!
\event\stageBattleArea50_002.msbt
CharaSerif_00_M	･･･ん？\nどうした？ こんなところで。
CharaSerif_00_F	･･･ん？\nどうしたの？ こんなところで。
CharaSerif_01_M	えっ？ おトクな{r[じょうほう]}情報{/r}がある･･･ だって？
CharaSerif_01_F	えっ？ おトクな{r[じょうほう]}情報{/r}がある･･･ ですって？
CharaSerif_02_M	おおっ！ {r[さら]}皿{/r}をつないでいる{r[とき]}時{/r}にこれを{r[と]}取{/r}ると\nそこから{c[ffae00]}さらに７{r[びょうかんさら]}秒間皿{/r}をつなげられる{c[000000]}のか！
CharaSerif_02_F	うおぅ♪ {r[さら]}皿{/r}をつないでいる{r[とき]}時{/r}にこれを{r[と]}取{/r}ると\nそこから{c[ffae00]}さらに７{r[びょうかんさら]}秒間皿{/r}をつなげられる{c[000000]}のね！
CharaSerif_03_M	へへっ♪ お{r[ちゃ]}茶{/r}でリフレッシュってわけだな？\nわかったぜ！ {r[おし]}教{/r}えてくれてありがとな！
CharaSerif_03_F	へへっ♪ お{r[ちゃ]}茶{/r}でリフレッシュってわけね？\nわかったわ！ {r[おし]}教{/r}えてくれてありがとう！
\event\stageBeginArea50_001.msbt
CharaSerif_00_M	{r[たいちょう]}隊長{/r}どの！\nスシガミバリアーの{r[じゅんび]}準備{/r}、{r[かんりょう]}完了{/r}しました！
CharaSerif_01_M	･･･うむ、スイッチを{r[い]}入{/r}れろ。
CharaSerif_02_M	はっ！ スシガミバリアー{r[きどう]}起動{/r}！
CharaSerif_02B_M	なあ、{r[いま]}今{/r}のなんだ？
CharaSerif_02B_F	ねえ、{r[いま]}今{/r}のなに？
CharaSerif_03_M	いいぞ･･･ これで、この{r[しま]}島{/r}のスシガミどもは\n{r[そと]}外{/r}に{r[で]}出{/r}られなくなった･･･！
CharaSerif_04_M	ヘヘッ♪ {r[れい]}例{/r}のスシガミを{r[お]}追{/r}ってきた{r[さき]}先{/r}が\n{r[しんしゅ]}新種{/r}のスシガミの{r[ほうこ]}宝庫{/r}とは･･･ ラッキーでしたね！
CharaSerif_04B_M	えっ!? {r[しんしゅ]}新種{/r}のスシガミ？
CharaSerif_05_M	しかし、この{r[しま]}島{/r}のスシガミ･･･ のんびりしてて\n{r[とら]}捉{/r}えどころがない･･･ ミョーな{r[れんちゅう]}連中{/r}だ。
CharaSerif_06_M	ひょっとして･･･ ケイヤクという{r[がいねん]}概念{/r}すら\nわかっていないのでは？
CharaSerif_07_M	フフフ･･･ だからこのバリアーで{r[と]}閉{/r}じ{r[こ]}込{/r}めて\nゴッソリさらって{r[い]}行{/r}こうというワケだ･･･！
CharaSerif_08_M	\u000e\u0000\u0002\u0002\u0096\u0000やめろ！ そんなことさせるか!!\u000e\u0000\u0002\u0002d\u0000
CharaSerif_08_F	\u000e\u0000\u0002\u0002\u0096\u0000このっ！ そんなことさせないわ!!\u000e\u0000\u0002\u0002d\u0000
CharaSerif_09_M	なにっ!?\nキサマはムサシ･･･ いつのまに！
CharaSerif_11_M	･･･へへっ！ しかしスシガミを{r[よ]}呼{/r}べない\nムサシなんて、{r[てき]}敵{/r}じゃありませんぜ！
CharaSerif_10_M	なにっ？ どういうことだ!?\n
CharaSerif_10_F	･･･なに？ どういうこと!?
CharaSerif_11B_M	フン･･･！ バリアーには、{r[しま]}島{/r}の{r[そと]}外{/r}のスシガミが\n{r[なか]}中{/r}に{r[はい]}入{/r}ってこれなくなる{r[こうか]}効果{/r}もあるのだ！
CharaSerif_12_M	\u000e\u0000\u0002\u0002\u0096\u0000なんだって!?\u000e\u0000\u0002\u0002d\u0000
CharaSerif_12_F	\u000e\u0000\u0002\u0002\u0096\u0000なんですって!?\u000e\u0000\u0002\u0002d\u0000
CharaSerif_13_M	（ムサシ、それは{r[まこと]}誠{/r}じゃ･･･ ワシらの{r[たましい]}魂{/r}は{r[しま]}島{/r}の{r[そと]}外{/r}。\n ワシは{r[いま]}今{/r}、おヌシの{r[こころ]}心{/r}に{r[ちょくせつかた]}直接語{/r}りかけておる･･･）
CharaSerif_14_M	くっ･･･！ それじゃバトルできないぜ･･･\nどうすりゃいいんだ･･･？
CharaSerif_14_F	くっ･･･！ それじゃバトルできない･･･\nどうすりゃいいの･･･？
CharaSerif_15_M	\u000e\u0000\u0002\u0002\u0096\u0000うおおっ!? なんだなんだ？\u000e\u0000\u0002\u0002d\u0000
CharaSerif_15_F	\u000e\u0000\u0002\u0002\u0096\u0000なっ、なに!? なんなの!?\u000e\u0000\u0002\u0002d\u0000
CharaSerif_16_M	･･･ああ!! そうか、この{r[しま]}島{/r}のスシガミだな!?\nちょうどよかった！ オレにチカラを･･･
CharaSerif_16_F	･･･ああ!! そうか、この{r[しま]}島{/r}のスシガミね!?\nちょうどよかった！ わたしにチカラを･･･
CharaSerif_18_M	おおっ！ チカラを{r[か]}貸{/r}してくれるのか!!\nなんだよ！ {r[はなし]}話{/r}がはやいな!!
CharaSerif_18_F	うおぅ♪ チカラを{r[か]}貸{/r}してくれるのね!!\nすごい！ {r[はなし]}話{/r}がはやーい♪
CharaSerif_19_M	えっ？ でもそれには、この「{c[91ff1e]}チャレンジけん{c[000000]}」の\nパワーが{r[ひつよう]}必要{/r}･･･？ へえ･･･
CharaSerif_19_F	えっ？ でもそれには、この「{c[91ff1e]}チャレンジけん{c[000000]}」の\nパワーが{r[ひつよう]}必要{/r}･･･？ ふーん･･･
CharaSerif_20_M	ムゥ･･･ まさかこの{r[しま]}島{/r}のスシガミを\n{r[みかた]}味方{/r}につけるとは･･･！
CharaSerif_21_M	ええい！ そのスシガミともども\n{r[われ]}我{/r}らが{r[ていこく]}帝国{/r}の{r[いだい]}偉大{/r}さを{r[おし]}教{/r}えてやれ!!
CharaSerif_22_M	\u000e\u0000\u0002\u0002\u0096\u0000はっ!!\u000e\u0000\u0002\u0002d\u0000
CharaSerif_23_M	{r[ほんぺん]}本編{/r}の{r[しんこうど]}進行度{/r}によらずお{r[たの]}楽{/r}しみいただくため、\nこのエリアではムサシは{c[ffae00]}Lv30{r[こてい]}固定{/r}{c[000000]}になります。
\event\stageBeginArea50_012.msbt
CharaSerif_00_M	う～ん･･･ ムサシちゃんまだかな～\nはやく{r[み]}見{/r}せびらかしたいのに･･･
CharaSerif_02_M	キャハ☆ きたきた！\nんじゃ、{r[み]}見{/r}せちゃおー♪ とっておきの{r[しんへいき]}新兵器{/r}！
CharaSerif_03_M	･･･なんだ？ ヘンな{r[いろ]}色{/r}の{r[ばくだん]}爆弾{/r}だな。
CharaSerif_03_F	えっ、なに？ そのヘンな{r[いろ]}色{/r}の{r[ばくだん]}爆弾{/r}･･･
CharaSerif_04_M	･･･もう！ これはスーパーボム!! フツーのより\n{r[はかいりょく]}破壊力{/r}があって、{r[かいじょ]}解除{/r}もムズいんだぞ～!!
CharaSerif_05_M	よーし！ じゃあ、いってみよ～！\nぜーったい{r[かいじょ]}解除{/r}しないでね？
\event\stageBeginArea50_020.msbt
CharaSerif_00_M	フフッ･･･ {r[しま]}島{/r}ノ{r[ほこら]}祠{/r}のスシガミ･･･\nツイニ{r[て]}手{/r}に{r[い]}入{/r}レタゾ･･･!!
CharaSerif_01_M	\u000e\u0000\u0002\u0002\u0096\u0000あーっ!! {r[けいやく]}契約{/r}しちゃった！\u000e\u0000\u0002\u0002d\u0000
CharaSerif_01B_M	フン･･･！ ヒトアシ{r[おそ]}遅{/r}カッタナ･･･\nコレデ、ワレラガ{r[しゅくがん]}宿願{/r}モ{r[たっせい]}達成{/r}サレル･･･
CharaSerif_02_M	{r[おし]}教{/r}エテヤロウ･･･\nコノスシガミのスキルは『{c[91ff1e]}スシ{r[づ]}詰{/r}め{r[てんごく]}天国{/r}{c[000000]}』･･･
CharaSerif_03_M	フハハハハハ･･･ {r[なに]}何{/r}モ{r[な]}無{/r}いレーンを{r[いっき]}一気{/r}にスシで\n{r[う]}埋{/r}め{r[つ]}尽{/r}くす{r[くうぜんぜつご]}空前絶後{/r}のイリョク･･･ {r[あじ]}味{/r}ワウガイイ!!
\event\stageEndArea50Ex005.msbt
CharaSerif_00_M	･･･えっ？\nいまのは･･･ バリアー{r[そうち]}装置{/r}？
CharaSerif_01_M	\u000e\u0000\u0002\u0002\u0096\u0000･･･ムサシ！ {r[ぶじ]}無事{/r}か!?\u000e\u0000\u0002\u0002d\u0000
CharaSerif_02_M	おおっ、ジンライ!! {r[しま]}島{/r}に{r[はい]}入{/r}ってこれたのか!?
CharaSerif_02_F	うおぅ♪ ジンライ!! {r[しま]}島{/r}に{r[はい]}入{/r}ってこれたのね!?
CharaSerif_03_M	ホッ･･･\nそれが、{r[きゅう]}急{/r}にバリアーが{r[き]}消{/r}えてな･･･
CharaSerif_04_M	そうか･･･ {r[たいほう]}大砲{/r}といっしょに{r[そうち]}装置{/r}がこわれて\n{r[しま]}島{/r}を{r[おお]}覆{/r}ってたバリアーがなくなったんだ･･･！
CharaSerif_04_F	そうか･･･ {r[たいほう]}大砲{/r}といっしょに{r[そうち]}装置{/r}がこわれて\n{r[しま]}島{/r}を{r[おお]}覆{/r}ってたバリアーがなくなったのね･･･！
CharaSerif_05_M	よう！ だっこスシガミたち!!\n{r[ていこく]}帝国{/r}もいなくなったし、これでもう{r[あんしん]}安心{/r}だぜ！
CharaSerif_05_F	ハーイ♪ だっこスシガミたち！\n{r[ていこく]}帝国{/r}もいなくなったし、これでもう{r[あんしん]}安心{/r}よ！
CharaSerif_06_M	ほう･･･？ おヌシたちが{r[きょうりょく]}協力{/r}してくれたのか。\nワシからも{r[れい]}礼{/r}を{r[い]}言{/r}わせてもらうぞ！
CharaSerif_08_M	へへっ♪ {r[たたか]}戦{/r}いの{r[なか]}中{/r}で{r[く]}食{/r}わせてもらったスシ･･･\nめっちゃうまかったぜ！
CharaSerif_08_F	へへっ♪ {r[たたか]}戦{/r}いの{r[なか]}中{/r}でいただいたスシ･･･\nすごいおいしかったわ！
CharaSerif_09_M	おう！ いっしょに{r[ていこく]}帝国{/r}と{r[たたか]}戦{/r}ったこと･･･\nぜったい{r[わす]}忘{/r}れないぜ！ いつかまた{r[あ]}会{/r}おうな!!
CharaSerif_09_F	うん！ いっしょに{r[ていこく]}帝国{/r}と{r[たたか]}戦{/r}ったこと･･･\nぜったい{r[わす]}忘{/r}れないわ！ またいつか{r[あ]}会{/r}いましょ!!
CharaSerif_11_M	『{c[91ff1e]}まぐろラッコのまぐろ{c[000000]}』を{r[て]}手{/r}に{r[い]}入{/r}れた！\n これは･･･!?
\event\stageEndArea50_001.msbt
CharaSerif_00_M	ちぇっ･･･ あのおかしな{r[そうち]}装置{/r}は\n{r[も]}持{/r}ち{r[さ]}去{/r}られちまったか･･･
CharaSerif_00_F	ちぇっ･･･ あのおかしな{r[そうち]}装置{/r}は\n{r[も]}持{/r}ち{r[さ]}去{/r}られたみたいね･･･
CharaSerif_03_M	おおっ、あんたたちは！\nおかげでたすかったぜ！
CharaSerif_03_F	うおぅ♪ さっきの{r[こ]}子{/r}たちね！\nおかげでたすかったわ！
CharaSerif_04_M	えっ？ スシを{r[わる]}悪{/r}いことに{r[つか]}使{/r}う{r[ていこく]}帝国{/r}はゆるせない･･･\nいっしょに{r[たたか]}戦{/r}ってほしい･･･ だって？
CharaSerif_04_F	えっ？ スシを{r[わる]}悪{/r}いことに{r[つか]}使{/r}う{r[ていこく]}帝国{/r}はゆるせない･･･\nいっしょに{r[たたか]}戦{/r}ってほしい･･･ ですって？
CharaSerif_01_M	よし、まかせろ！ {r[ていこくぐん]}帝国軍{/r}を{r[お]}追{/r}っぱらって\n{r[へいわ]}平和{/r}な{r[しま]}島{/r}を{r[と]}取{/r}りもどそうぜ！
CharaSerif_01_F	よーし、まかせて！ {r[ていこくぐん]}帝国軍{/r}を{r[お]}追{/r}っぱらって\n{r[へいわ]}平和{/r}な{r[しま]}島{/r}を{r[と]}取{/r}りもどしましょ！
\event\stageEndArea50_020.msbt
CharaSerif_04_M	ソンナ･･･ ワレラノ{r[しゅくがん]}宿願{/r}･･･\n{r[ていこく]}帝国{/r}への{r[かいてんずし]}回転寿司{/r}･･･ {r[せっちけいかく]}設置計画{/r}･･･ ガ･･･
CharaSerif_05_M	･･･なんだ？\n{r[かいてんずし]}回転寿司{/r}を{r[つく]}作{/r}ろうとしてたのか？
CharaSerif_05_F	･･･えっ？\n{r[かいてんずし]}回転寿司{/r}を{r[つく]}作{/r}ろうとしてたの？
CharaSerif_06_M	へへっ♪ {r[かいてんずし]}回転寿司{/r}は、みんなのいこいの{r[ば]}場{/r}！\nスシを{r[どくせん]}独占{/r}する{r[ていこく]}帝国{/r}にゃ、もったいないぜ!!
CharaSerif_06_F	へへっ♪ {r[かいてんずし]}回転寿司{/r}は、みんなのいこいの{r[ば]}場{/r}よ！\nスシを{r[どくせん]}独占{/r}する{r[ていこく]}帝国{/r}には、もったいないわ!!
CharaSerif_07_M	コシャクナ･･･！ イイ{r[き]}気{/r}にナルなよ･･･\nバリアー{r[はっせいそうち]}発生装置{/r}は、マダ{r[さどう]}作動{/r}シテイルノダ･･･！
CharaSerif_08_M	フハハハハハ･･･ ツマリ{r[しま]}島{/r}のスシガミは{r[と]}閉{/r}ジ{r[こ]}込{/r}メ\nラれたママ！ ワレワレは･･･ マダ{r[ま]}負{/r}ケテ･･････
CharaSerif_00_M	ほっほっほっほっ！ あやうく{r[ていこく]}帝国{/r}で\n{r[かいてんずし]}回転寿司{/r}を{r[かいてん]}開店{/r}させられる{r[ところ]}所{/r}だったぞよ～♪
CharaSerif_01_M	おおっ！ あのキャッテンの{r[しんせき]}親戚{/r}だな!?\nオレにチカラを{r[か]}貸{/r}してくれ！
CharaSerif_01_F	うおぅ♪ あのキャッテンの{r[しんせき]}親戚{/r}ね!?\nわたしにチカラを{r[か]}貸{/r}してちょうだい！
CharaSerif_02_M	ほっほっほぅ～♪ まあ、そう{r[せ]}急{/r}くでない。\nそちの{r[た]}食{/r}べっぷり、もうしばし{r[み]}見{/r}せてたもれ･･･
CharaSerif_03_M	『{c[91ff1e]}みけいやくの{r[さら]}皿{/r}{c[000000]}』を{r[て]}手{/r}に{r[い]}入{/r}れた！
\scene\scene_battleresult.msbt
Text_Clear	クリア!!
Text_Cleared	クリアずみ
Text_ExpMax	さいだい
Text_LevelUp	レベルアップ!
Text_Score	スコア
Text_HighScore	ハイスコア
Text_EatDishNumUnit_zr	皿
Text_EatDishNumUnit_sg	皿
Text_EatDishNumUnit_pl	皿
Text_EatDish	たべたスシ
Text_ClearTimeBonus	クリアタイムボーナス
Text_FavPowerBonus	スシパワーボーナス
Text_BlackBeltBonus	くろおびボーナス
Text_ItemNone	なし
Text_Rank	ランク
Text_Exp	けいけんち
Text_GetItem	かくとくアイテム
Text_BattleResult	バトルけっか
Text_StarBonus	かくとくボーナス\u00d7%d
Win_GetFavPower00	リミットまで{r[た]}食{/r}べた！
Win_GetFavPower01	スシパワー『{c[91ff1e]}\u000e\u0001\u0017\u0000{c[000000]}』が\n{r[からだ]}体{/r}にやどった！
Win_GetFavPowerTitle	スシパワーかくとく！
Label_ExStage_Advent	エリアクリア ＆ スター40個の{r[かくとく]}獲得{/r}で…\nエリア『{c[006e00]}\u000e\u0001\u0013\u0000{c[000000]}』の\n{c[dc0000]}かくしステージ{c[000000]}がオープン！
Label_ExStage30_Advent	エリアクリア ＆ スター30個の{r[かくとく]}獲得{/r}で…\nエリア『{c[006e00]}\u000e\u0001\u0013\u0000{c[000000]}』の\n{c[dc0000]}かくしステージ{c[000000]}がオープン！
Win_Collabo_GetItemTitle	アイテムかくとく！
\scene\scene_cmn.msbt
Label_AreaNumber	エリア %ls
Btn_Next	つぎへ
Btn_ToMap_FromEvent	マップへ
Btn_ToMap_FromArea	マップへ
Btn_ToMusashi	ムサシへ
Btn_Back	もどる
Btn_Menu	メニュー
Btn_Decide	けってい
Btn_Chinju	ちんじゅ\nのもり
Btn_Battle	バトル！
Btn_SeeEnemyInfo	てきデータをみる
Btn_EventReplay	おはなしリプレイ
Btn_Close	とじる
Btn_Change	へんこう
Btn_Skill	スキル
Btn_Sushi	スシ
Btn_Data	データ
Btn_OK	OK
Btn_Yes	はい
Btn_No	いいえ
Btn_Use	つかう
Btn_Watch	みる
BtnSort	けいやくじゅん
BtnSortSushiGodName	スシガミ{r[めい]}名{/r}
BtnSortSushiGodLv	スシガミレベル
BtnSortSkillName	スキル{r[めい]}名{/r}
BtnSortDicNo	{r[だいひゃっか]}大百科{/r}ナンバー
BtnSecret	ひみつ
BtnAppearance	すがた
Text_Sushi	スシ
Text_SushiReinforcement	メニューが{r[きょうか]}強化{/r}された!
Text_Life	たいりょく
Text_PlayerPower	うでっぷし
Text_DiffencePower	まもりのチカラ
Text_Skill	スキル
Text_Lv	Lv
Text_HP	HP
Text_VS	VS
Text_MainTeam	ジブンのスシガミ
List_Sorting	ならべかえ
List_SelectSort	ならび{r[じゅん]}順{/r}を{r[えら]}選{/r}んでください
List_Remove	はずす
Text_Connecting	{r[つうしんちゅう]}通信中{/r}
Text_Waiting	{r[たいきちゅう]}待機中{/r}
Text_Searching	{r[けんさくちゅう]}検索中{/r}
Text_ReSearch	{r[さいけんさく]}再検索{/r}
Text_HeroName	ムサシ
Win_FileNameInput	ファイル{r[めい]}名{/r}を{r[にゅうりょく]}入力{/r}してください。\n{c[dc0000]}※{r[つうしんたいせん]}通信対戦{/r}やランキングで{r[こうかい]}公開{/r}されます。\n　{r[こじんじょうほう]}個人情報{/r}など{r[ふてきせつ]}不適切{/r}な{r[ないよう]}内容{/r}は\n　{r[か]}書{/r}かないでください。{c[000000]}
Label_ErrorText	以下の文字は使用できません。\nもう一度入力してください。
Txt_PlayTime	プレイじかん
Txt_StageEX	ex.
Btn_Skip	スキップ
Txt_VersionNo	Ver. 1.1.0
WinCollaboTicket_Title	『チャレンジけん』
WinCollaboTicket_Num	\u00d7 %d
WinCollaboTicket_GetFirst	『{c[006e00]}チャレンジけん{c[000000]}』\u00d7 %d を{r[て]}手{/r}に{r[い]}入{/r}れた！\n{r[うみ]}海{/r}の{r[む]}向{/r}こうに{r[あら]}新{/r}たなエリアが{r[あらわ]}現{/r}れた…！
WinCollaboTicket_Get	『{c[006e00]}チャレンジけん{c[000000]}』\u00d7 %d を{r[て]}手{/r}に{r[い]}入{/r}れた！
WinCollaboTicket_Confirm	『{c[006e00]}チャレンジけん{c[000000]}』\u00d71 を{r[つか]}使{/r}って\nバトルに{r[ちょうせん]}挑戦{/r}しますか？
\scene\scene_map.msbt
Label_UnknownEnemy	?????????
Label_Opponent	たいせんあいて
Label_RecommendLevel	おすすめ Lv
Label_God	スシガミ
Label_UseGod	つかうスシガミ
Label_Treasure	おたから
Label_Rank	ランク
Label_Result	けっか
Label_NoResult	みちょうせん
Label_Score	ハイスコア
Label_Star	スター
Label_SelectDestination	{r[い]}行{/r}き{r[さき]}先{/r}を{r[えら]}選{/r}ぼう
Label_ClearRate	クリアりつ
Label_GetRank	かくとくランク
Label_Owner	あるじ
Label_Explain	かいせつ
Label_BuildingLevel	たてもの Lv
Label_SushibarFacilityName	まねき{r[ずし]}寿司{/r}
Label_SushibarOwner	キャッテン
Label_SushibarText	{r[せかいじゅう]}世界中{/r}から{r[ひと]}人{/r}と{r[じょうほう]}情報{/r}が{r[あつ]}集{/r}まる{r[せかいはつ]}世界初{/r}の{r[かいてんずしてん]}回転寿司店{/r}。\nドートンやお{r[きゃく]}客{/r}さんたちから、いろんな{r[はなし]}話{/r}が{r[き]}聞{/r}ける！
Label_ShrineFacilityName	スシガミ{r[じんじゃ]}神社{/r}
Label_ShrineOwner	ミコ
Label_ShrineText	{r[おお]}大{/r}スシガミ{r[さま]}様{/r}がまつられている、{r[さいこ]}最古{/r}の{r[じんじゃ]}神社{/r}。\nスシライカーランクの{r[にんてい]}認定{/r}もしてくれる！
Label_TowerFacilityName	パズルタワー
Label_TowerOwner	ドートン
Label_TowerOwner_02	バンブーク
Label_TowerText	スシ{r[ざら]}皿{/r}パズルバトルに{r[ちょうせん]}挑戦{/r}！\nドートンが{r[つく]}作{/r}ったカラクリロボが{r[あいて]}相手{/r}になる。
Label_ArenaFacilityName	{r[とうぎじょう]}闘技場{/r}
Label_ArenaOwner	ドートン
Label_ArenaOwner_02	ソスナ
Label_ArenaText	{r[つうしん]}通信{/r}で{r[ほか]}他{/r}のプレイヤーと{r[たいせん]}対戦{/r}ができる！\nライバルたちとの{r[あつ]}熱{/r}いバトルを{r[たの]}楽{/r}しもう！
Label_KoziinFacilityName	チビっこハウス
Label_KoziinOwner	ユーリア
Label_KoziinText	{r[きょうわこく]}共和国{/r}じゅうの{r[みよ]}身寄{/r}りのない{r[こども]}子供{/r}たちを{r[う]}受{/r}け{r[い]}入{/r}れるため、\nムサシの{r[むら]}村{/r}から{r[いせつ]}移設{/r}された{r[しせつ]}施設{/r}。
Title_Arena_Battle01	ガチバトル
Text_Arena_Battle01	いつものルールでガチバトル！
Title_Arena_Battle02	バラエティバトル
Text_Arena_Battle02	なんでもアリのドタバタバトル！
Title_Arena_LocalBattle	ローカル{r[たいせん]}対戦{/r}
Title_Arena_NetBattle	インターネット{r[たいせん]}対戦{/r}
Title_Arena_RandomMatch	ランダムマッチ
Text_Arena_RandomMatch	全国のライバルとスシバトル！
Title_Arena_FriendMatch	フレンドマッチ
Text_Arena_FriendMatch	おなじみのフレンドとスシバトル！
Title_Arena_GachiRatingBattle	ガチレーティングバトル
Text_Arena_GachiRatingBattle	かちまけでレートがかわるガチバトル！
Text_Arena_RandomVarietyBattle	レートが近いライバルたちと！
Text_Arena_Rate	レート
Text_Arena_RateRanking	レート\nランキング
Text_Arena_WinNum	{r[か]}勝{/r}ち{r[すう]}数{/r}
Text_Arena_Recruiting	{r[たいせんあいて]}対戦相手{/r}の{r[ぼしゅう]}募集{/r}
Title_Tower_Battle	パズルバトル
Text_Tower_Battle	５手ですべての皿をとれ！
Text_Tower_WinNum	{r[か]}勝{/r}ちぬき{r[すう]}数{/r}
Text_Shrine_SushiLikerRank	スシライカーランク
Text_Shrine_Rank_Up	ランクアップ！
Btn_SerialCode	シリアルコード
Btn_Challenge	チャレンジ！
Win_SerialCode_Confirm	インターネットに{r[せつぞく]}接続{/r}して\nキャンペーン{r[よう]}用{/r}の{c[dc0000]}シリアルコード{c[000000]}を\n{r[〿にゅうりょく]}入力{/r}しますか？
Win_SerialCode_ConfirmNext	{r[つづ]}続{/r}けて{c[dc0000]}シリアルコード{c[000000]}を{r[にゅうりょく]}入力{/r}しますか？
Win_CollaboTicket_HaveNot	『{c[006e00]}チャレンジけん{c[000000]}』がありません。\nこのエリアのステージに{r[ちょうせん]}挑戦{/r}するには、\nキャンペーン{r[よう]}用{/r}の{c[dc0000]}シリアルコード{c[000000]}を{r[にゅうりょく]}入力{/r}し\n『{c[006e00]}チャレンジけん{c[000000]}』を{r[にゅうしゅ]}入手{/r}してください。
Win_CollaboTicket_Full	『{c[006e00]}チャレンジけん{c[000000]}』がいっぱいです。\nバトルで『{c[006e00]}チャレンジけん{c[000000]}』を{r[しよう]}使用{/r}した{r[あと]}後{/r}\n{r[さいど]}再度{/r}{c[dc0000]}シリアルコード{c[000000]}を{r[にゅうりょく]}入力{/r}してください。
Win_SerialCode_Error_PeriodOut	キャンペーンは{r[げんざいかいさい]}現在開催{/r}されていません。\n{c[dc0000]}シリアルコード{c[000000]}の{r[にゅうりょく]}入力{/r}はできません。
Win_SerialCode_Error_Stop	キャンペーンは{r[げんざいていしちゅう]}現在停止中{/r}です。\n{c[dc0000]}シリアルコード{c[000000]}の{r[にゅうりょく]}入力{/r}はできません。
Win_SerialCode_Error_WrongCode	{r[にゅうりょく]}入力{/r}された{c[dc0000]}シリアルコード{c[000000]}は{r[ただ]}正{/r}しく\nありません。{r[にゅうりょく]}入力{/r}まちがいがないか、\nもう{r[いちど]}一度{/r}ご{r[かくにん]}確認{/r}ください。
Win_SerialCode_Error_ExpiredCode	{c[dc0000]}シリアルコード{c[000000]}の{r[ゆうこうきげん]}有効期限{/r}が\n{r[き]}切{/r}れています。
Win_SerialCode_Error_UsedCode_Others	この{c[dc0000]}シリアルコード{c[000000]}は{r[しようず]}使用済{/r}みです。\n{r[ほか]}他{/r}のユーザーが{r[つか]}使{/r}った{c[dc0000]}シリアルコード{c[000000]}は\n{r[しようず]}使用済{/r}みとなり、{r[しよう]}使用{/r}できません。
Win_SerialCode_Error_UsedCode_Myself	この{c[dc0000]}シリアルコード{c[000000]}は\nすでに{r[にゅうりょくず]}入力済{/r}みです。
Win_SerialCode_Error_Invalidated	この{c[dc0000]}シリアルコード{c[000000]}は{r[むこうか]}無効化{/r}されました。
Win_SerialCode_Error_System_Error	{c[dc0000]}シリアルコード{c[000000]}のシステムエラーが{r[はっせい]}発生{/r}しました。\nしばらく{r[ま]}待{/r}ってからコードを{r[にゅうりょく]}入力{/r}しなおしてください。
Win_SerialCode_Error_Disconnect	{r[つうしん]}通信{/r}が{r[せつだん]}切断{/r}されました。\n「{c[006e00]}シリアルコード{c[000000]}」ボタンから、{r[あらた]}改{/r}めて\n{c[dc0000]}シリアルコード{c[000000]}を{r[にゅうりょく]}入力{/r}してください。
\scene\scene_menuencyclopedia.msbt
TxtSceneName	スシガミ{r[だいひゃっか]}大百科{/r}
TxtGod	スシガミ
TxtCommentary	かいせつ
TxtAwake	かくせい
TxtEatNum	たべた数 %d
TxtGrade	グレード
TxtDictionaryNo	#%03d
TxtGodSecret	%lsのひみつ
TxtNoContract	※{r[けいやく]}契約{/r}はできません
TxtGodSecretInfo	　　はたしてどんなスシガミなのか…!?\n　　それは、いまだ{r[なぞ]}謎{/r}につつまれている…
TxtSushiSecretInfo	おヌシがまだ{r[た]}食{/r}べたことがないネタじゃな
TxtCollaboContract	※いっしょに{r[たたか]}戦{/r}った{r[きねん]}記念{/r}
\scene\scene_puzzlebattle.msbt
DishColorName00	{c[acfdfb]}①{c[000000]}
DishColorName01	{c[ffcc2f]}①{c[000000]}
DishColorName02	{c[d3b5fd]}①{c[000000]}
DishColorName03	{c[5fd871]}①{c[000000]}
DishColorName04	{c[6e91f3]}①{c[000000]}
DishColorName05	{c[fd592b]}①{c[000000]}
DishColorName06	{c[d4e9ec]}①{c[000000]}
DishColorName07	{c[6a6c49]}①{c[000000]}
DishColorName08	{c[f0e8a5]}①{c[000000]}
DishColorNameRainbow	\u000e\u0000\u0003\u0004\u00fc\u00fc\u00fc\u0000①{c[000000]}
GraphicText_VS	VS
Text_Live	LIVE
Text_Win	勝ち
Text_Lose	負け
Text_Left	のこり   
Text_Sec	秒
Text_Opponent	たいせんあいて
Text_FinishBlow	とどめのアタック
Text_Score	スコア
Text_Pause	PAUSE
Text_Condition	このステージのスターかくとく条件
Text_Continue	つづける
Text_Retry	やりなおす
Text_Exit	やめる
Text_DemoPlay	おてほん{r[さいせいちゅう]}再生中{/r}…
Text_SkillReady	 準備 OK !
Text_Combo	コンボ
Text_Combo_Wall	コンボ
Text_EqualSushi	同ネタ
Text_Fes	スシまつり
Text_Skilleffect	スキルこうか
Text_Sushipower	スシパワー
CmnLane_Scroll	きょうつうレーン　　　
GetItem_ItemSkillChager	スキルチャージャー！
GetItem_ItemFesChager	まつりチャージャー！
GetItem_ItemTimeStop	タイムストップ！
GetItem_ItemThunderLower	アタックサンダー！
GetItem_ItemThunderUpper	おてつきサンダー！
GetItem_ItemCapsuleBom	ボムかいじょ！
GetItem_ItemCapsuleThunder	アタックサンダー！
GetItem_ItemCapsuleRedBom	スーパーボムかいじょ！
GetItem_ItemCapsulePotato	HP5000かいふく！
GetItem_ItemCapsuleGreenTea	つなぎじかんアップ！
TxtWindowCollaboBackCheck	{r[つか]}使{/r}った『{c[006e00]}チャレンジけん{c[000000]}』は\nもどってきません。よろしいですか？
TxtSkillComboCampaign	コンボボーナス x%ls！
Player_Chr001_HpLow75	まけないぜ！
Player_Chr001_HpLow50	まだまだ！！
Player_Chr001_HpLow25	ヤバい…！！
Player_Chr001_HpLow12	だいピンチ…！
Player_Chr001_HpLow75_f	まけないわ！
Player_Chr001_HpLow50_f	まだまだ！！
Player_Chr001_HpLow25_f	やばッ…！！
Player_Chr001_HpLow12_f	だいピンチ…！
Enemy_Chr016_Win	われら{r[ていこく]}帝国{/r}に{r[はむ]}歯向{/r}かうなど…！！\n{r[み]}身{/r}のほど{r[し]}知{/r}らずがッ！！
Enemy_StgWin_001	{r[ていこく]}帝国{/r}に{r[はむ]}歯向{/r}かうとどうなるか\n{r[おも]}思{/r}い{r[し]}知{/r}ったか！
Enemy_StgWin_002	ハハハ！\n{r[くち]}口{/r}ほどにもないヤツだ！！
Enemy_StgWin_003	ふふんっ！こうなるのが{r[とうぜん]}当然{/r}さ！\nオレのチカラ、{r[おも]}思{/r}い{r[し]}知{/r}ったか！！
Enemy_StgWin_004	{r[み]}見{/r}たかスイーツ{r[てんごく]}天国{/r}のチカラをッ！
Enemy_StgWin_005	ハハハ！どうだ！\n{r[でんげき]}電撃{/r}シュートはシビれるだろう？
Enemy_StgWin_006	くくく…\nこのバリアシールドは{r[やぶ]}破{/r}れまい！
Enemy_StgWin_007	{r[ぼうそうとっきゅう]}暴走特急{/r}レーンのスピードに\n{r[て]}手{/r}も{r[あし]}足{/r}も{r[で]}出{/r}まい！！
Enemy_StgWin_008	フフフッ…！\nやはりまだまだ{r[こども]}子供{/r}でしたねえ！！
Enemy_StgWin_009	どうだ{r[こぞう]}小僧{/r}！\nオレの{r[とつげき]}突撃{/r}にたえられまい！！
Enemy_StgWin_009_f	どうだ{r[こむすめ]}小娘{/r}！\nオレの{r[とつげき]}突撃{/r}にたえられまい！！
Enemy_StgWin_010	ふはは！\nカプセルの{r[つか]}使{/r}い{r[かた]}方{/r}がまだまだだな！
Enemy_StgWin_011	{r[とくしゅ]}特殊{/r}レーンのチカラ、\nおそれ{r[い]}入{/r}ったか！
Enemy_StgWin_012	このパカーチンの{r[な]}名{/r}にかけて\nここを{r[とお]}通{/r}すわけにはいかんっ！！
Enemy_StgWin_013	ふふんっ！{r[み]}見{/r}たことかムサシ！\nこれが{r[ていこくぐん]}帝国軍{/r}のオレのチカラさ！！
Enemy_StgWin_014	キミのようなチビッコには\nまだまだ{r[きんにく]}筋肉{/r}が{r[た]}足{/r}りないのだよ
Enemy_StgWin_015	{r[きんにく]}筋肉{/r}があるか{r[な]}無{/r}いか\nそれが{r[しょうぶ]}勝負{/r}の{r[わ]}分{/r}かれ{r[め]}目{/r}なのさっ！
Enemy_StgWin_016	マッチョのなかのマッチョである\n{r[わたし]}私{/r}のマッチョにつぶされるがいい！
Enemy_StgWin_017	マッチョ{r[たいちょう]}隊長{/r}である{r[わたし]}私{/r}の{r[まえ]}前{/r}に\nひざまづいてもらおうか！！
Enemy_StgWin_018	やってやったぜ！\nこれでクビにならなくてすむぜ♪
Enemy_StgWin_019	ははは！スシシャッフラーで\n{r[こんらん]}混乱{/r}したようだな！！
Enemy_StgWin_020	スシライカー　ムサシ…\nその{r[ていど]}程度{/r}なんてひょうしぬけ…
Enemy_StgWin_021	ユーリアのミスをカバー！\nこれで{r[わたし]}私{/r}の{r[しょうしん]}昇進{/r}も{r[ゆめ]}夢{/r}じゃない！！
Enemy_StgWin_022	ユーリアが{r[とお]}通{/r}しても\nわたしがここを{r[とお]}通{/r}さんッ！！
Enemy_StgWin_023	{r[ざんねん]}残念{/r}だったな{r[こぞう]}小僧{/r}！\nここを{r[とお]}通{/r}すことはできん！！
Enemy_StgWin_023_f	{r[ざんねん]}残念{/r}だったな{r[こむすめ]}小娘{/r}！\nここを{r[とお]}通{/r}すことはできん！！
Enemy_StgWin_024	{r[ほうこく]}報告{/r}にあったムサシとはお{r[まえ]}前{/r}だな！\n{r[くち]}口{/r}ほどにも{r[な]}無{/r}いやつよ！！
Enemy_StgWin_025	しょせんはこの{r[ていど]}程度{/r}なのね…\nバカ…みたい……
Enemy_StgWin_026	ふはははは！\nこの{r[きんにく]}筋肉{/r}の{r[まえ]}前{/r}に{r[てき]}敵{/r}はない！！
Enemy_StgWin_027	オレの{r[きんにく]}筋肉{/r}は{r[むてき]}無敵{/r}！\nムテキンニク！！
Enemy_StgWin_028	{r[きんにく]}筋肉{/r}で　ムサシを{r[と]}止{/r}めて\n　{r[われ]}我{/r}{r[かんき]}歓喜{/r}　……ふふ、{r[いっく]}一句{/r}{r[よ]}詠{/r}めた
Enemy_StgWin_029	{r[み]}見{/r}たか！　これが{r[ていこく]}帝国{/r}の\n{r[きんにく]}筋肉{/r}スシライカーのチカラだ！
Enemy_StgWin_030	これで…\nようやく{r[せんそう]}戦争{/r}も{r[お]}終{/r}わるわ……
Enemy_StgWin_031	がーっはっはっはっは！\nバキュームバキューム！！
Enemy_StgWin_032	ゴホッ…！せきが{r[と]}止{/r}まらないが\n{r[ていこくぐん]}帝国軍{/r}として{r[ま]}負{/r}けられな…ゴホッ！
Enemy_StgWin_033	ドライアイで{r[め]}目{/r}が{r[かわ]}乾{/r}いてたけど\nなんとか{r[か]}勝{/r}つことができたか……
Enemy_StgWin_034	{r[はな]}鼻{/r}がつまっていたがスシは{r[く]}食{/r}える！\nつまり{r[ま]}負{/r}ける{r[ようそ]}要素{/r}はゼロだ！！
Enemy_StgWin_035	{r[あさ]}朝{/r}から{r[あたま]}頭{/r}がフラフラしていたが\n{r[たいちょうふりょう]}体調不良{/r}をものともせずに{r[しょうり]}勝利{/r}！！
Enemy_StgWin_036	ありゃりゃ？？\n{r[きょう]}今日{/r}はキレがないっすね～
Enemy_StgWin_037	ふふふ♪\nいぇい、あたしの{r[か]}勝{/r}ちぃ～♪♪
Enemy_StgWin_038	お{r[ねえ]}姉{/r}さんの{r[か]}勝{/r}～ち♪\nまた{r[あそ]}遊{/r}んであげるね～♪♪
Enemy_StgWin_039	うふふ♪\nキミには{r[か]}勝{/r}たせてあげないよ～だ♪
Enemy_StgWin_040	わ～い、{r[か]}勝{/r}ったぞ～♪\nバンブークさまにほめてもらえる♪
Enemy_StgWin_041	どうだムサシ！\nオケ{r[はざま]}狭間{/r}の{r[たたか]}戦{/r}いはすごいだろう！！
Enemy_StgWin_042	ワサビ{r[い]}入{/r}りのスシも{r[く]}食{/r}えないのに\n{r[われわれ]}我々{/r}には{r[か]}勝{/r}てるはずがないだろう♪
Enemy_StgWin_043	ワサビ{r[い]}入{/r}りのスシは{r[びみ]}美味{/r}だな！\n{r[きさま]}貴様{/r}もそう{r[おも]}思{/r}うだろうムサシ！？
Enemy_StgWin_044	うひゃひゃ～♪\nワサビうまいいいいい！！
Enemy_StgWin_045	オレとワサビのコンビネーションで\n{r[きさま]}貴様{/r}もここでおしまいだ！！
Enemy_StgWin_046	カレオツでした～♪\n{r[きょう]}今日{/r}は{r[ちょうし]}調子{/r}{r[わる]}悪{/r}かったようですね～
Enemy_StgWin_047	{r[わたし]}私{/r}の{r[か]}勝{/r}ちね～♪\n{r[ざんねん]}残念{/r}だけどここは{r[とお]}通{/r}せないわ
Enemy_StgWin_048	あは♪ {r[か]}勝{/r}っちゃった～♪\nこれでかくれんぼに{r[さんか]}参加{/r}できるわ～
Enemy_StgWin_049	{r[か]}勝{/r}った～♪バンブークさまに\nナデナデしてもらおっと♪♪
Enemy_StgWin_050	ムサシちゃんもつよいけど\n{r[わたし]}私{/r}のほうがもっとつよいみたい～♪
Enemy_StgWin_051	ワサビ{r[い]}入{/r}りのスシをガマンして\n{r[た]}食{/r}べたカイがあったぜ！！
Enemy_StgWin_052	どうじゃワサビ{r[だい]}大{/r}サービスは！\nこれが{r[おとな]}大人{/r}のスシというものじゃ！
Enemy_StgWin_053	くく…グロムさまの{r[ぶたい]}部隊{/r}の\n{r[ぞうえん]}増援{/r}が{r[な]}無{/r}くても{r[らくしょう]}楽勝{/r}だったな
Enemy_StgWin_054	{r[こうぶつ]}好物{/r}のスシさえ{r[で]}出{/r}てくれば\n{r[ま]}負{/r}けることなど{r[な]}無{/r}いのだ！！
Enemy_StgWin_055	{r[おも]}思{/r}ったよりも{r[は]}歯{/r}ごたえがないな\n{r[ようちゅうい]}要注意{/r}との{r[つうたつ]}通達{/r}は{r[ごほう]}誤報{/r}だったか
Enemy_StgWin_056	{r[こども]}子供{/r}が{r[あいて]}相手{/r}でも{r[ゆだん]}油断{/r}しなかった\n{r[しんちょう]}慎重{/r}さでつかんだ{r[しょうり]}勝利{/r}だ！！
Enemy_StgWin_057	{r[きょう]}今日{/r}のムーゲーは\nボクの{r[か]}勝{/r}ちってことで～♪
Enemy_StgWin_058	{r[ちょくぞくぶたい]}直属部隊{/r}の{r[わたし]}私{/r}にかかれば\n{r[はいぼく]}敗北{/r}などあり{r[え]}得{/r}ないのだよ
Enemy_StgWin_059	はっはっは！ エリートである\n{r[わたし]}私{/r}にかかればイチコロだな！
Enemy_StgWin_060	{r[わたし]}私{/r}に{r[ま]}負{/r}けたからと{r[い]}言{/r}って\n{r[は]}恥{/r}じることは{r[な]}無{/r}いぞ！！
Enemy_StgWin_061	グロムさま{r[ちょくぞく]}直属{/r}のエリート{r[ぶたい]}部隊{/r}に\nたてつくからこうなるのだ!!
Enemy_StgWin_062	はーっはっはっは！ {r[み]}見{/r}たか！\n{r[ていこくぐん]}帝国軍{/r}{r[とくべつせい]}特別製{/r}{r[でんじほう]}電磁砲{/r}の{r[いりょく]}威力{/r}を！！
Enemy_StgWin_063	{r[でんじほう]}電磁砲{/r}を{r[とっぱ]}突破{/r}するのに\nチカラを{r[つか]}使{/r}いすぎたようだな!!
Enemy_StgWin_064	ウワサほど{r[たい]}大{/r}したことないな！\n{r[たいちょう]}隊長{/r}が{r[で]}出{/r}てくるまでもない!!
Enemy_StgWin_065	{r[しょくよく]}食欲{/r}に{r[まさ]}勝{/r}る{r[さくせん]}作戦{/r}ナシ！\n{r[た]}食{/r}べ{r[つづ]}続{/r}ければ{r[か]}勝{/r}てるのだー！！
Enemy_StgWin_066	ムサシを{r[と]}止{/r}めた{r[ぶたい]}部隊{/r}として\n{r[わ]}我{/r}が{r[たい]}隊{/r}の{r[しょうしん]}昇進{/r}も{r[かくじつ]}確実{/r}だな！！
Enemy_StgWin_067	グロムさまのあとを\n{r[お]}追{/r}わせるわけにはいかん！！
Enemy_StgWin_068	ムサシ{r[げきは]}撃破{/r}を{r[しゅく]}祝{/r}して\n{r[わ]}我{/r}が{r[たい]}隊{/r}でスシパーティだ！！
Enemy_StgWin_069	あ、あれ？ {r[ようつう]}腰痛{/r}をカバーしながら\n{r[たたか]}戦{/r}っていたら{r[か]}勝{/r}っちゃった…！
Enemy_StgWin_070	オレのほうがスシのことを\nより{r[あい]}愛{/r}していたということだ！！
Enemy_StgWin_071	この{r[さき]}先{/r}には{r[い]}行{/r}かせんと{r[い]}言{/r}っただろ！\n{r[き]}聞{/r}いていなかったのか！？
Enemy_StgWin_072	ムサシ…か\nそこそこ{r[たの]}楽{/r}しませてもらったぞ
Enemy_StgWin_073	どうです！ これが{r[かいほうせんせん]}解放戦線{/r}が\n{r[ついきゅう]}追求{/r}してきた{r[ごうりてき]}合理的{/r}バトル…！！
Enemy_StgWin_074	{r[きさま]}貴様{/r}らの{r[しんぐん]}進軍{/r}もここまでだな！
Enemy_StgWin_075	スシ{r[かいほうせんせん]}解放戦線{/r}のムサシ\n{r[おそ]}恐{/r}るるに{r[た]}足{/r}らず…！！
Enemy_StgWin_076	{r[くち]}口{/r}ほどにもない！\nさあトドメをさしてやろう！！
Enemy_StgWin_077	{r[しょうり]}勝利{/r}の{r[あじ]}味{/r}は\nいつだって{r[びみ]}美味{/r}だぜ！！
Enemy_StgWin_078	あなたよりもボクのほうが\nヨイツーですね～♪
Enemy_StgWin_079	おじょうさまの{r[めいれい]}命令{/r}は{r[ぜったい]}絶対{/r}です\nここは{r[とお]}通{/r}せませんよ
Enemy_StgWin_080	おじょうさまの{r[めいれい]}命令{/r}には{r[ふくじゅう]}服従{/r}です\nこの{r[さき]}先{/r}には{r[とお]}通{/r}せません
Enemy_StgWin_081	おじょうさまの{r[めいれい]}命令{/r}は{r[しじょう]}至上{/r}です\nここから{r[さき]}先{/r}には{r[い]}行{/r}かせませんよ
Enemy_StgWin_082	おじょうさまの{r[めいれい]}命令{/r}は{r[げんしゅ]}厳守{/r}です\nよってここはお{r[とお]}通{/r}しできません
Enemy_StgWin_083	やった…やったぞ！\nオレだってやればできるんだ！！
Enemy_StgWin_084	どうだ{r[み]}見{/r}たか！\n{r[あか]}赤{/r}いスシなど{r[た]}食{/r}べなくても{r[か]}勝{/r}てる！
Enemy_StgWin_085	ははは！ これで{r[あか]}赤{/r}いスシが\n{r[な]}無{/r}くても{r[か]}勝{/r}てると{r[しょうめい]}証明{/r}されたな！！
Enemy_StgWin_086	{r[あか]}赤{/r}いスシなど{r[た]}食{/r}べなくても\n{r[われわれ]}我々{/r}は{r[つよ]}強{/r}いのだーーー！！
Enemy_StgWin_087	うひゃひゃひゃ！\n{r[あか]}赤{/r}いスシなど{r[な]}無{/r}くても{r[か]}勝{/r}てるのだ！
Enemy_StgWin_088	ありゃりゃ！？\nボクが{r[か]}勝{/r}っちゃいました～♪
Enemy_StgWin_089	おじょうさまの{r[しじ]}指示{/r}ですので\nここはお{r[とお]}通{/r}しできません
Enemy_StgWin_090	{r[もう]}申{/r}し{r[わけ]}訳{/r}ありませんムサシさま\nここを{r[とお]}通{/r}すことはできません
Enemy_StgWin_091	ここでムサシさまを{r[と]}止{/r}めるのが\nわたしがおおせつかった{r[やくめ]}役目{/r}です
Enemy_StgWin_092	ムサシさまの{r[かいしんげき]}快進撃{/r}も\nここまでのようですね
Enemy_StgWin_093	やったああ！　よ～し、ソスナ{r[たい]}隊{/r}\nから{r[しゅっせかいどう]}出世街道{/r}まっしぐらだー！！
Enemy_StgWin_094	はんっ！ アタイに{r[いど]}挑{/r}もうなんざ\n{r[み]}身{/r}のほどをわきまえるんだね!!
Enemy_StgWin_095	ここは{r[とお]}通{/r}せん！\nそれにしても{r[きょう]}今日{/r}は{r[ひ]}冷{/r}えるな…
Enemy_StgWin_096	{r[か]}勝{/r}ってしまった… まだこの{r[さむ]}寒{/r}い{r[なか]}中{/r}で\n{r[ばん]}番{/r}を{r[つづ]}続{/r}けないといけないのか……
Enemy_StgWin_097	{r[さむ]}寒{/r}いけど、ムサシには{r[か]}勝{/r}てた！\nいい{r[ひ]}日{/r}だな{r[きょう]}今日{/r}は!!
Enemy_StgWin_098	{r[さむ]}寒{/r}さにも{r[う]}打{/r}ち{r[か]}勝{/r}ち\nムサシにも{r[しょうり]}勝利{/r}!!
Enemy_StgWin_099	{r[ていこく]}帝国{/r}に{r[はむ]}歯向{/r}かうとどうなるか\n{r[こんど]}今度{/r}こそ、{r[おも]}思{/r}い{r[し]}知{/r}ったか！
Enemy_StgWin_100	やはりチビッコだな！\n{r[きんにく]}筋肉{/r}がぜんぜん{r[た]}足{/r}りんッ!!
Enemy_StgWin_101	{r[きんにく]}筋肉{/r}があれば、この{r[かんれい]}寒冷{/r}の{r[ち]}地{/r}でも\n{r[ふく]}服{/r}など{r[ひつよう]}必要{/r}…………ないッッ!!
Enemy_StgWin_102	マッチョのなかのマッチョである\n{r[わたし]}私{/r}がついにムサシを{r[たお]}倒{/r}したぞ！！
Enemy_StgWin_103	{r[ま]}負{/r}けたからには、マッチョ{r[ぶたい]}部隊{/r}に\n{r[にゅうたい]}入隊{/r}してもらおうか！！
Enemy_StgWin_104	「もと」{r[しれいかん]}司令官{/r}のチカラ\n{r[おも]}思{/r}い{r[し]}知{/r}ったか！！
Enemy_StgWin_105	どうだーー！ワサビの{r[くんれん]}訓練{/r}を\n{r[う]}受{/r}けたおかげで{r[か]}勝{/r}てたぞ！！
Enemy_StgWin_106	{r[か]}勝{/r}ったぞ！\n{r[み]}見{/r}よ！{r[しょうり]}勝利{/r}のパンプアップ！！
Enemy_StgWin_107	ムテキンニクはやはり{r[けんざい]}健在{/r}！！
Enemy_StgWin_108	{r[きんにく]}筋肉{/r}は　ムサシを{r[と]}止{/r}める\nためにある　…ふふ、{r[よ]}良{/r}い{r[いっく]}一句{/r}だ
Enemy_StgWin_109	{r[われわれ]}我々{/r}{r[きんにく]}筋肉{/r}スシライカーが\n{r[ていこく]}帝国{/r}を{r[ささ]}支{/r}えているのだ！！
Enemy_StgWin_110	{r[しんにゅうしゃ]}侵入者{/r}を{r[はいじょ]}排除{/r}…！ なんといっても\n{r[わたし]}私{/r}はここの{r[かんしゅ]}看守{/r}だからなあ!!
Enemy_StgWin_111	{r[いりょく]}威力{/r}の{r[ま]}増{/r}したバキューム{r[ぐ]}食{/r}い！\n{r[おそ]}恐{/r}れいったかムサシ!! ガハハ!!
Enemy_StgWin_112	{r[ぶたい]}部隊{/r}で{r[さいきょう]}最強{/r}の{r[わたし]}私{/r}を{r[あいて]}相手{/r}にしたんだ\n{r[ま]}負{/r}けて{r[とうぜん]}当然{/r}だよムサシくん!!
Enemy_StgWin_113	この{r[ぶたい]}部隊{/r}で{r[さいきょう]}最強{/r}のボクを{r[あいて]}相手{/r}に\n{r[ぜんせん]}善戦{/r}したほうじゃないかな？
Enemy_StgWin_114	オレが{r[ぶたい]}部隊{/r}で{r[さいきょう]}最強{/r}だった\nってだけの{r[はなし]}話{/r}だから{r[き]}気{/r}にするな!!
Enemy_StgWin_115	{r[とうぜん]}当然{/r}、{r[たいちょう]}隊長{/r}のオレが{r[いちばん]}一番{/r}{r[つよ]}強{/r}い！\nだからキミは{r[ま]}負{/r}けて{r[あ]}当{/r}たり{r[まえ]}前{/r}さ!!
Enemy_StgWin_116	ムサシさんカレオツっすか～？\nいつものキレがないっすよ～♪
Enemy_StgWin_117	{r[つぎ]}次{/r}にひかえるルツコイが\n{r[で]}出{/r}てくるまでもなかったな！！
Enemy_StgWin_118	この{r[おく]}奥{/r}のマツイには{r[わる]}悪{/r}いが\n{r[でばん]}出番{/r}は{r[な]}無{/r}さそうだな、ハッハッハ！
Enemy_StgWin_119	{r[たいちょう]}隊長{/r}が{r[で]}出{/r}てくるまでもなく\nこのマツイがムサシを{r[げきは]}撃破{/r}ッ！！
Enemy_StgWin_120	{r[ぶか]}部下{/r}たちではやはりダメだったか…\n{r[たいちょう]}隊長{/r}の{r[わたし]}私{/r}はひと{r[あじ]}味{/r}ちがったろう？
Enemy_StgWin_121	{r[もくひょう]}目標{/r}！ {r[でんじほう]}電磁砲{/r}の{r[ほうげき]}砲撃{/r}により{r[ちんもく]}沈黙{/r}!!
Enemy_StgWin_122	アブリコス{r[たい]}隊{/r}ほど{r[きんにく]}筋肉{/r}は{r[な]}無{/r}いが\nお{r[まえ]}前{/r}を{r[たお]}倒{/r}すにはそれで{r[じゅうぶん]}十分{/r}だッ!!
Enemy_StgWin_123	バンブーク{r[たい]}隊{/r}のように{r[たいりょう]}大量{/r}ワサビを\n{r[つか]}使{/r}えばもっと{r[らくしょう]}楽勝{/r}だったかな！？
Enemy_StgWin_124	{r[あか]}赤{/r}いスシを{r[た]}食{/r}べないソスナ{r[たい]}隊{/r}{r[せんぽう]}戦法{/r}を\n{r[ため]}試{/r}すつもりが、ふつうに{r[か]}勝{/r}てたな！
Enemy_StgWin_125	グロム{r[たい]}隊{/r}のようなエレガントさは\n{r[な]}無{/r}いが、{r[わ]}我{/r}が{r[たい]}隊{/r}もゴージャスだろう
Enemy_StgWin_126	このナカムラ、おまえのスシ{r[すじ]}筋{/r}は\nすでに{r[みき]}見切{/r}った！
Enemy_StgWin_127	グロムさまと{r[きず]}築{/r}き{r[あ]}上{/r}げてきた\nスシへの{r[しんねん]}信念{/r}、ここにありッ！！
Enemy_StgWin_128	おまえの「スシ{r[すじ]}筋{/r}」…\nグロムさまほどでは{r[な]}無{/r}かったな！！
Enemy_StgWin_129	{r[われ]}我{/r}ら{r[せいえいぶたい]}精鋭部隊{/r}が{r[あいて]}相手{/r}ではさすがに\n{r[ぶ]}分{/r}が{r[わる]}悪{/r}かったようだな…？
Enemy_StgWin_130	この{r[でんじほう]}電磁砲{/r}がこの{r[ち]}地{/r}の{r[かなめ]}要{/r}なのだ！\n{r[とっぱ]}突破{/r}されるわけにはいかんッ！！
Enemy_StgWin_131	{r[ちち]}父{/r}を{r[こ]}越{/r}えられぬかムサシよ！\nスシへの{r[しんねん]}信念{/r}はその{r[ていど]}程度{/r}かッ！？
Enemy_StgWin_132	ココカラ{r[さき]}先{/r}ニハ　{r[すす]}進{/r}マセナイ…
Enemy_StgWin_133	オ{r[まえ]}前{/r}ノ{r[ま]}負{/r}ケ…\nココハ　{r[とお]}通{/r}サナイ……
Enemy_StgWin_134	{r[われ]}我{/r}ハ　ココヲ　{r[まも]}守{/r}ル\nソレダケダ……
Enemy_StgWin_135	コノ{r[しょうり]}勝利{/r}ハ　グラードサマニ\n{r[ささ]}捧{/r}ゲサセテ　モラオウ…
Enemy_StgWin_136	ありゃ？　パイセンもいるのに\nどうしちゃったんですか～？？
Enemy_StgWin_137	{r[こども]}子供{/r}ノ　クセニ\n{r[ず]}図{/r}ニ{r[の]}乗{/r}ルカラ　コウナルノダ…
Enemy_StgWin_138	ソノ　{r[ちい]}小{/r}サナ　{r[からだ]}体{/r}デ　アガイテモ\n{r[むだ]}無駄{/r}ナコトダ……
Enemy_StgWin_139	クク…スシ{r[ほかんけいかく]}補完計画{/r}ノ{r[しんこう]}進行{/r}ニハ\nナンラ{r[えいきょう]}影響{/r}ハ{r[な]}無{/r}イナ……
Enemy_StgWin_140	グラードサマノ　トコロマデ\n{r[すす]}進{/r}マレル　ワケニハイカヌ…
Enemy_StgWin_141	スシハ　{r[ていこく]}帝国{/r}デ\n{r[どくせん]}独占{/r}サセテ　モラウトシヨウ…
Enemy_StgWin_142	ジュウベエニハ　{r[さき]}先{/r}ニ{r[い]}行{/r}カレタガ\nオマエハ　ココマデダ…！
Enemy_StgWin_143	{r[ていこく]}帝国{/r}ガ　{r[えが]}描{/r}ク{r[しこう]}至高{/r}ノ{r[みらい]}未来{/r}ニ\n{r[きさま]}貴様{/r}モ　{r[したが]}従{/r}ッテモラオウ…
Enemy_StgWin_144	グラードサマニ　{r[ちか]}近{/r}ヅコウナド\n{r[ぐこう]}愚行{/r}ニモ　ホドガアル……
Enemy_StgWin_145	さあ…キミのスシも\nすべてボクに{r[さ]}差{/r}し{r[だ]}出{/r}して…
Enemy_StgWin_146	どうして{r[わら]}笑{/r}ってスシを{r[た]}食{/r}べるんだい\nそんなもの{r[むいみ]}無意味{/r}だというのに……
Enemy_StgWin_197	さあ、その{r[いし]}石{/r}を{r[わた]}渡{/r}してもらおうか！
Enemy_StgWin_198	その{r[いし]}石{/r}は{r[ていこく]}帝国{/r}のものだ！\nイーシッシッシ♪
Enemy_StgWin_199	この{r[さき]}先{/r}の{r[じんじゃ]}神社{/r}には\nこれ{r[いじょう]}以上{/r}は{r[ちか]}近{/r}づかせん！
Enemy_StgWin_200	そちらにも{r[じょうほうつう]}情報通{/r}がいるようだが\n{r[おも]}思{/r}い{r[どお]}通{/r}りにはさせんぞ！
Enemy_StgWin_201	{r[わ]}我{/r}がマッチョボディで\n{r[つうこうど]}通行止{/r}めだあ！！
Enemy_StgWin_202	マッチョ～マッチョ～{r[たいそう]}体操{/r}～♪\n{r[か]}勝{/r}っても{r[ま]}負{/r}けてもマッチョ{r[たいそう]}体操{/r}～♪
Enemy_StgWin_203	{r[ぶたい]}部隊{/r}で{r[いちばん]}一番{/r}{r[つよ]}強{/r}いと{r[い]}言{/r}われた{r[わたし]}私{/r}が\n{r[ま]}負{/r}けるはずないのだ！！
Enemy_StgWin_204	この{r[たい]}隊{/r}で{r[さいきょう]}最強{/r}だと{r[い]}言{/r}われた{r[わたし]}私{/r}に\n{r[いど]}挑{/r}んだのは{r[ふうん]}不運{/r}だったな…！
Enemy_StgWin_205	{r[ぶたいさいきょうへいし]}部隊最強兵士{/r}の{r[しょうごう]}称号{/r}を{r[も]}持{/r}つ{r[わたし]}私{/r}に\n{r[か]}勝{/r}とうなど{r[しょうしせんばん]}笑止千万{/r}ッ！！
Enemy_StgWin_206	ほめて{r[の]}伸{/r}ばした{r[ぶか]}部下{/r}たちは{r[ぜんめつ]}全滅{/r}だが\n{r[れい]}例{/r}のギアは{r[われわれ]}我々{/r}がいただくぞ！！
Enemy_StgWin_209	ふん！ここはキサマが{r[く]}来{/r}るような\nところではないのだ！！
Enemy_StgWin_210	{r[けいび]}警備{/r}の{r[にんむ]}任務{/r}は\nきっちりと{r[は]}果{/r}たさせてもらったぞ！
Enemy_StgWin_211	この{r[さき]}先{/r}の{r[ぐんじしせつ]}軍事施設{/r}には\n{r[い]}行{/r}かせんぞ！！
Enemy_StgWin_212	{r[ていこく]}帝国{/r}の{r[いだい]}偉大{/r}な{r[はつめい]}発明{/r}を\n{r[じゃま]}邪魔{/r}されるわけにはいかん！！
Enemy_StgWin_213	{r[か]}勝{/r}った！{r[か]}勝{/r}ったぞ！\n{r[ぶたい]}部隊{/r}で{r[さいじゃく]}最弱{/r}でもやればできるんだ！
Enemy_StgWin_214	{r[ぶたい]}部隊{/r}で{r[いちばん]}一番{/r}{r[よわ]}弱{/r}いと{r[たいちょう]}隊長{/r}に{r[い]}言{/r}われ\n{r[ひっし]}必死{/r}に{r[く]}食{/r}らいついた{r[かい]}甲斐{/r}があった！
Enemy_StgWin_215	{r[ぶたいさいじゃくへいし]}部隊最弱兵士{/r}の{r[しょうごう]}称号{/r}などという\n{r[わたし]}私{/r}の{r[おめい]}汚名{/r}も{r[きょう]}今日{/r}で{r[へんじょう]}返上{/r}だ！！
Enemy_StgWin_216	{r[しり]}尻{/r}をたたいて{r[そだ]}育{/r}てた{r[ぶか]}部下{/r}は{r[ぜんめつ]}全滅{/r}して\n{r[わたし]}私{/r}まで{r[ま]}負{/r}けるわけにはいかんのだ！
Enemy_StgWin_217	この{r[さき]}先{/r}の{r[しせつ]}施設{/r}には{r[い]}行{/r}かせんぞ！\nキサマは{r[でんじほう]}電磁砲{/r}のえじきだ!!
Enemy_StgWin_218	{r[たいせつ]}大切{/r}な{r[じっけんそうち]}実験装置{/r}を{r[こわ]}壊{/r}した{r[むく]}報{/r}い\nしっかりと{r[う]}受{/r}けてもらうぞ!!
Enemy_StgWin_219	フン… {r[くち]}口{/r}ほどにもナイ…\n{r[ていこく]}帝国{/r}の{r[けいかく]}計画{/r}を{r[だま]}黙{/r}って{r[み]}見{/r}てイロ…！
Enemy_StgWin_221	ふう…レアスシガミのことを\nうっかり{r[くち]}口{/r}にするところだったぜ
Enemy_StgWin_222	この{r[さき]}先{/r}にはなにも{r[な]}無{/r}い！\nましてレアスシガミなどおらん!!
Enemy_StgWin_223	キサマをここで{r[と]}止{/r}められれば\n{r[たいちょう]}隊長{/r}にしかられることもないのだ！
Enemy_StgWin_224	{r[わたし]}私{/r}とゴクオウとの\nコンビネーションはどうだ！
Enemy_StgWin_225	どお？\nおねえさんは{r[つよ]}強{/r}いでしょ～？
Enemy_StgWin_226	うふふ♪ スシバトルよりも\nおねえさんと{r[うみ]}海{/r}で{r[あそ]}遊{/r}ぼうよう？
Enemy_StgWin_227	この{r[さき]}先{/r}には{r[だれ]}誰{/r}も{r[とお]}通{/r}すなって{r[たいちょう]}隊長{/r}に\n{r[い]}言{/r}われているので{r[とお]}通{/r}せませ～ん♪
Enemy_StgWin_228	ぶんどりシールド…\n{r[すば]}素晴{/r}らしいチカラだわ…！
Enemy_StgWin_233	おじょうさまのご{r[めいれい]}命令{/r}は\n{r[ぜったいじゅんしゅ]}絶対遵守{/r}！ {r[ぜったいげんしゅ]}絶対厳守{/r}！
Enemy_StgWin_234	ふふふ… {r[あか]}赤{/r}いスシを{r[た]}食{/r}べない\nスタイルも{r[いた]}板{/r}についてきました
Enemy_StgWin_235	{r[われわれ]}我々{/r}がバトルで{r[じかん]}時間{/r}をかせげば\nおじょうさまはエステに{r[い]}行{/r}ける！
Enemy_StgWin_236	おじょうさまが{r[もど]}戻{/r}られるまで\nこのほこらには{r[ちか]}近{/r}づかせません！
Enemy_StgWin_237	ソスナさまの{r[ぶたい]}部隊{/r}に{r[か]}代{/r}わって\nここは{r[わたし]}私{/r}が{r[ふうさ]}封鎖{/r}させてもらう！
Enemy_StgWin_238	{r[あぶ]}危{/r}ない{r[あぶ]}危{/r}ない…。この{r[さき]}先{/r}に\n{r[すす]}進{/r}まれたら{r[たいちょう]}隊長{/r}から{r[おおめだま]}大目玉{/r}だよ…
Enemy_StgWin_239	スシバトルは{r[わたし]}私{/r}の{r[か]}勝{/r}ちだ！\nここから{r[さき]}先{/r}には{r[とお]}通{/r}さんぞ！！
Enemy_StgWin_240	ちょっと{r[でおく]}出遅{/r}れたが\nほこらは{r[もんだい]}問題{/r}なく{r[かくほ]}確保{/r}！！
Enemy_StgWin_249	あっ、{r[か]}勝{/r}っちゃった\n{r[たいちょう]}隊長{/r}、スシガミはどうですか？
Enemy_StgWin_250	おっ、オレの{r[か]}勝{/r}ちか…！\nスシガミは{r[あらわ]}現{/r}れましたか{r[たいちょう]}隊長{/r}？
Enemy_StgWin_251	{r[か]}勝{/r}ちました{r[たいちょう]}隊長{/r}！\nスシガミは{r[で]}出{/r}ましたか！？
Enemy_StgWin_252	{r[ゆくえふめい]}行方不明{/r}のスシガミも{r[み]}見{/r}つかり\nムサシも{r[たお]}倒{/r}し、{r[ばんばんざい]}万々歳{/r}だ!!
Enemy_StgWin_253	{r[わたし]}私{/r}を{r[たお]}倒{/r}して{r[さき]}先{/r}に{r[すす]}進{/r}もうとするなど\n{r[ていこくへい]}帝国兵{/r}もなめられたものだ…！
Enemy_StgWin_254	くくくっ…うっかりミスを\nムサシとともにもみ{r[け]}消{/r}したぜ！
Enemy_StgWin_255	スシガミがいようがいなかろうが\nムサシが{r[あらわ]}現{/r}れたのなら{r[たお]}倒{/r}すのみ!!
Enemy_StgWin_256	うう… {r[さむ]}寒{/r}いのに{r[か]}勝{/r}ってしまった…\nまだ{r[けいび]}警備{/r}を{r[つづ]}続{/r}けないとじゃないか…
Enemy_StgWin_257	さーて、{r[ゆき]}雪{/r}に{r[う]}埋{/r}もれてしまった\nほこらを{r[さが]}探{/r}すとするか
Enemy_StgWin_258	さあ、ほこらは{r[われわれ]}我々{/r}のものだ！\nそこをどいてもらおうか!!
Enemy_StgWin_259	{r[ひさびさ]}久々{/r}のスシバトル…\nまだまだ{r[うで]}腕{/r}はなまってないぜ…！
Enemy_StgWin_260	さ～て、バトルも{r[お]}終{/r}わったし\n{r[み]}身{/r}を{r[かく]}隠{/r}す{r[くんれん]}訓練{/r}にもどらなければ…！
Enemy_StgWin_261	よしっ、バトル{r[お]}終{/r}わり！\nかくれないとオニが{r[き]}来{/r}てしまう！
Enemy_StgWin_262	も～い～か～い！\nさあ、{r[さが]}探{/r}すぞぉ～!!
Enemy_StgWin_263	うふふ…ムシャクシャしてたから\nと～ってもスカッとしたわ♪
Enemy_StgWin_264	{r[きん]}筋{/r}トレの{r[よ]}良{/r}い{r[いきぬ]}息抜{/r}きになったよ！\nはーっはっはっはっは！！
Enemy_StgWin_265	この{r[うつく]}美{/r}しい{r[ふうけい]}風景{/r}には\n{r[わ]}我{/r}が{r[きんにく]}筋肉{/r}がとても{r[は]}映{/r}える…！
Enemy_StgWin_266	さてさて、ほこらの{r[ちょうさ]}調査{/r}に{r[もど]}戻{/r}る{r[まえ]}前{/r}に\nまずは{r[きん]}筋{/r}トレだッ！！
Enemy_StgWin_267	よし、{r[ゆくえふめい]}行方不明{/r}の{r[きんにく]}筋肉{/r}の{r[そうさく]}捜索{/r}に\n{r[もど]}戻{/r}らせてもらうとしよう
Enemy_StgWin_268	{r[わたし]}私{/r}はランボルギーニン…\nスシとマッチョを{r[きわ]}極{/r}めるもの…
Enemy_StgWin_269	ここは{r[ていこく]}帝国{/r}が{r[ふうさ]}封鎖{/r}しているのだ！\n{r[とお]}通{/r}すことはできんぞ！！
Enemy_StgWin_270	やんちゃなだけのようだな\nそんなやつにここは{r[わた]}渡{/r}さんぞ！
Enemy_StgWin_271	ククク…\nコレゾ　カメレサツノ　チカラ……
Enemy_StgWin_272	おや？　この{r[ていど]}程度{/r}でしたか…\nいつもの{r[げんき]}元気{/r}はどうしたんです？
Enemy_StgWin_273	きゃはは♪\nちょ～とやりすぎちゃったかな？
Enemy_StgWin_274	{r[か]}勝{/r}ち{r[ぼし]}星{/r}いただきました～！\nボクってじつは{r[つよ]}強{/r}いんですかね～♪
Enemy_StgWin_275	あ、あれ？　この{r[まえ]}前{/r}は{r[ま]}負{/r}けたのに\n{r[きょう]}今日{/r}は{r[か]}勝{/r}てたぞ！　やったああ！！
Enemy_StgWin_276	{r[しょうり]}勝利{/r}は{r[わ]}我{/r}が{r[て]}手{/r}に！　{r[か]}勝{/r}ちには{r[か]}勝{/r}ちの\n{r[ま]}負{/r}けには{r[ま]}負{/r}けの{r[りゆう]}理由{/r}があるのですよ
Enemy_StgWin_277	がーはっはっはっは！\nオレ{r[さま]}様{/r}の{r[きんにく]}筋肉{/r}の{r[まえ]}前{/r}にひれ{r[ふ]}伏{/r}しな！！
Enemy_StgWin_278	まだまだ{r[あま]}甘{/r}ちゃんだねえ！\nアタイがたたき{r[なお]}直{/r}してあげるよ！！
Enemy_StgWin_279	{r[あぶ]}危{/r}ナイ{r[あぶ]}危{/r}ナイ　{r[きゅう]}急{/r}ニ{r[かぜ]}風{/r}ガ{r[ふ]}吹{/r}クカラ\nマントガ　メクレルトコロダッタ
Enemy_StgWin_280	こりもせずにまた{r[いど]}挑{/r}んでくるなんて\nほんと…バカみたい……
Enemy_StgWin_281	ボクの{r[か]}勝{/r}ちだね…\nもっとスシが{r[た]}食{/r}べたいなあ……
Enemy_StgWin_282	むはは！　{r[わたし]}私{/r}のヒラメ{r[きん]}筋{/r}を{r[まえ]}前{/r}に\n{r[て]}手{/r}も{r[あし]}足{/r}も{r[で]}出{/r}なかったようだね！！
Enemy_StgWin_283	スシライカーのムサシか…\nスシ{r[すじ]}筋{/r}は{r[わる]}悪{/r}くなかったぞ
Enemy_StgWin_284	ワサビはまだ{r[にがて]}苦手{/r}なのかの？\n{r[おとな]}大人{/r}への{r[なかまい]}仲間入{/r}りは{r[とお]}遠{/r}いのお…
Enemy_StgWin_285	お{r[まえ]}前{/r}の{r[じつりょく]}実力{/r}はこの{r[ていど]}程度{/r}か？\nスシ{r[すじ]}筋{/r}ににごりが{r[み]}見{/r}えるぞ…！
Enemy_StgWin_286	{r[み]}見{/r}たか{r[ていこくぐん]}帝国軍{/r}の{r[ひみつへいき]}秘密兵器{/r}\nウルトラスーパー{r[でんじほう]}電磁砲{/r}の{r[いりょく]}威力{/r}を！
Enemy_StgWin_287	ちょっといきなりなんなのよ！\nえっ…あなたもムサシって{r[なまえ]}名前{/r}！？
Enemy_StgWin_288	この{r[まえ]}前{/r}は{r[ま]}負{/r}けちゃったけど\n{r[きょう]}今日{/r}は{r[か]}勝{/r}たせてもらったわよ♪
Enemy_StgWin_289	ふふふ…{r[わたし]}私{/r}すら{r[たお]}倒{/r}せなくて\nどうやって{r[ていこく]}帝国{/r}に{r[か]}勝{/r}つのですか？
Enemy_StgWin_290	おいおい、{r[いったい]}一体{/r}どうしたムサシ\nお{r[まえ]}前{/r}のスシ{r[すじ]}筋{/r}はもっと{r[するど]}鋭{/r}いだろう？
Enemy_StgWin_291	この{r[しょうり]}勝利{/r}をおじょうさまに{r[ささ]}捧{/r}げて\n{r[か]}代{/r}わりにほめてもらうとしよう！
Enemy_StgWin_292	めちゃくちゃに{r[さら]}皿{/r}を{r[な]}投{/r}げていたら\nよくわからないけど{r[か]}勝{/r}てたぞ♪
Enemy_StgWin_293	どうした{r[わ]}我{/r}が{r[こ]}子{/r}よ\nお{r[まえ]}前{/r}のチカラはその{r[ていど]}程度{/r}か？
Enemy_StgWin_294	オット{r[あぶ]}危{/r}ナイ　{r[こうふん]}興奮{/r}シスギテ\n{r[かめん]}仮面{/r}ガ　{r[はず]}外{/r}レル　トコロダッタ…
Enemy_StgWin_295	ワサビも{r[た]}食{/r}べられんこわっぱには\nまだまだ{r[おく]}遅{/r}れを{r[と]}取{/r}らんぞ♪
Enemy_StgWin_296	もしかして{r[きょう]}今日{/r}はカレオツでした？\n{r[うご]}動{/r}きにキレがなかったですよ～？
Enemy_StgWin_297	このブ{r[あつ]}厚{/r}い{r[むないた]}胸板{/r}の{r[まえ]}前{/r}では、お{r[まえ]}前{/r}が\n{r[な]}投{/r}げた{r[さら]}皿{/r}など{r[いた]}痛{/r}くもかゆくもない！
Enemy_StgWin_298	はんっ！　{r[あか]}赤{/r}いスシを{r[た]}食{/r}べるような\nお{r[こさま]}子様{/r}に{r[おく]}遅{/r}れを{r[と]}取{/r}るわけないのよ！
Enemy_StgWin_299	この{r[ていど]}程度{/r}の{r[じつりょく]}実力{/r}で{r[いど]}挑{/r}んできたの？\n{r[せんそう]}戦争{/r}を{r[お]}終{/r}わらせるなんて{r[ゆめ]}夢{/r}の{r[はなし]}話{/r}ね…
Enemy_StgWin_300	よーし{r[か]}勝{/r}ったぞ！\nさっそくグロムさまに{r[ほうこく]}報告{/r}だ！！
Enemy_StgWin_301	もう{r[お]}終{/r}わりなの？\nもっともっとスシを{r[た]}食{/r}べたいなあ…
Enemy_StgWin_302	いきなりなんなんだ！\nえっ…お{r[まえ]}前{/r}もムサシって{r[なまえ]}名前{/r}！？
Enemy_StgWin_C_001	さあ、{r[しま]}島{/r}を{r[で]}出{/r}て{r[い]}行{/r}ってもらおうか！\nここのスシガミは{r[ていこく]}帝国{/r}がいただく！
Enemy_StgWin_C_002	ネタをだっこするスシガミ…\nこんなスシガミは{r[はじ]}初{/r}めて{r[み]}見{/r}たぞ…！
Enemy_StgWin_C_003	この{r[しま]}島{/r}のスシガミは{r[とくちょうてき]}特徴的{/r}だな！\n{r[よ]}呼{/r}び{r[な]}名{/r}をつけてあげたいところだ！
Enemy_StgWin_C_004	スシガミがネタをだっこする{r[すがた]}姿{/r}が\n{r[き]}気{/r}になって{r[しゅうちゅう]}集中{/r}できないんだろう？
Enemy_StgWin_C_005	{r[おく]}奥{/r}ノ{r[ほこら]}祠{/r}ニイルトイウ　スシガミハ\n{r[われわれ]}我々{/r}{r[ていこく]}帝国{/r}ガ　イタダイテイク！
Enemy_StgWin_C_006	{r[わたし]}私{/r}はネタをだっこするよりも\nプロテインをだっこしたいね…！
Enemy_StgWin_C_007	そのスシガミ…よく{r[み]}見{/r}ると\nぷるぷる{r[ふる]}震{/r}えて、{r[むしゃぶる]}武者震{/r}いか！？
Enemy_StgWin_C_008	さあ{r[あい]}愛{/r}らしい{r[すがた]}姿{/r}のスシガミたちよ！\nムサシではなく{r[わたし]}私{/r}とともにゆこう！
Enemy_StgWin_C_009	このアイランドのスシガミたちよ！\nマッチョを{r[おそ]}恐{/r}れる{r[ひつよう]}必要{/r}はないぞッ！
Enemy_StgWin_C_010	{r[きさま]}貴様{/r}ダケハ　コノ{r[おく]}奥{/r}ノ{r[ほこら]}祠{/r}ニ\n{r[ぜったい]}絶対{/r}ニ　{r[ちか]}近{/r}ヅカセンゾ…！
Enemy_StgWin_C_011	ねぇねぇスシガミちゃんたち～！\nムサシちゃんより{r[わたし]}私{/r}と{r[あそ]}遊{/r}ぼ～よ～♪
Enemy_StgWin_C_012	ネタをだっこするスシガミちゃんを\n{r[わたし]}私{/r}がだっこしよっかな～♪
Enemy_StgWin_C_013	スシガミたち{r[ちょう]}超{/r}ラブリ～♪\n{r[わたし]}私{/r}この{r[しま]}島{/r}に{r[す]}住{/r}む～！
Enemy_StgWin_C_014	やだっ！スシガミの！プリティな！\n{r[すがた]}姿{/r}に！{r[こころ]}心{/r}が！いやされる…っ！
Enemy_StgWin_C_015	{r[おく]}奥{/r}ニアル{r[ほこら]}祠{/r}ハ　{r[われわれ]}我々{/r}{r[ていこくぐん]}帝国軍{/r}ガ\nイタダイテ　イクゾ…！
Enemy_StgWin_C_016	きゅぅぅん！この{r[しま]}島{/r}のスシガミは\nみんなかわいい！ぜんぶ{r[ほ]}欲{/r}しいぞ！
Enemy_StgWin_C_017	{r[しま]}島{/r}のスシガミからチカラを{r[か]}借{/r}りても\n{r[わ]}我{/r}が{r[ていこく]}帝国{/r}にはかなわんぞ！
Enemy_StgWin_C_018	おれにも…なにかを…\nだっこさせろーーー！！
Enemy_StgWin_C_019	{r[じゃまもの]}邪魔者{/r}はいなくなった！この{r[しま]}島{/r}でも\nスシ{r[ほかんけいかく]}補完計画{/r}を{r[すす]}進{/r}めるとしよう…！
Enemy_StgWin_C_020	サテサテ　ソレデハ　{r[れい]}例{/r}ノ{r[けいかく]}計画{/r}ヲ\n{r[すす]}進{/r}メサセテ　モラウトシヨウ…
Enemy_StgWin_C_021	この{r[けいかく]}計画{/r}は{r[ていこく]}帝国{/r}の{r[たいがん]}大願{/r}である！\n{r[きさま]}貴様{/r}ごときに{r[じゃま]}邪魔{/r}はさせんぞ…！
Enemy_StgWin_C_022	さーて、どうやってスシガミたちを\nこの{r[しま]}島{/r}から{r[つ]}連{/r}れ{r[だ]}出{/r}そうか…
Enemy_StgWin_C_023	スシガミにひとつ{r[ちゅうこく]}忠告{/r}しよう。\nネタはおんぶしたほうが{r[らく]}楽{/r}だぞ…！
Enemy_StgWin_C_024	{r[たいせつ]}大切{/r}なものをだっこすることで\n{r[あいじょう]}愛情{/r}を{r[ひょうげん]}表現{/r}しているわけだな！？
Enemy_StgWin_C_025	この{r[しま]}島{/r}は{r[みち]}未知{/r}のスシガミの{r[ほうこ]}宝庫{/r}！\n{r[きさま]}貴様{/r}たちに{r[わた]}渡{/r}すわけにはいかん！
Enemy_StgLose_001	こんな{r[こども]}子供{/r}に…\n{r[ぎゃく]}逆{/r}にひねりつぶされるなんて～…
Enemy_StgLose_002	{r[たいちょう]}隊長{/r}の{r[わたし]}私{/r}が{r[ま]}負{/r}けるなんて……\nお{r[まえ]}前{/r}… いったい{r[なにもの]}何者{/r}だ…!?
Enemy_StgLose_003	レ、レーンドライブギアなんて…\nはんそくだーーーーーっ!!
Enemy_StgLose_004	スイーツ{r[てんごく]}天国{/r}のチカラがあったのに\n{r[ま]}負{/r}けたというのか…
Enemy_StgLose_005	バカな… {r[でんげき]}電撃{/r}シュートが\n{r[き]}効{/r}かないというのか…!?
Enemy_StgLose_006	そ、そんな…\nバリアシールドで{r[ふせ]}防{/r}げないなんて…
Enemy_StgLose_007	{r[ぼうそうとっきゅう]}暴走特急{/r}レーンのスピードに\nついてこられたというのか…！？
Enemy_StgLose_008	くっ…\n{r[こども]}子供{/r}だと{r[おも]}思{/r}って{r[ゆだん]}油断{/r}しました…
Enemy_StgLose_009	{r[とつげき]}突撃{/r}するだけじゃ\n{r[か]}勝{/r}てないというのか…
Enemy_StgLose_010	くそっ…　バトルでカプセルを\nうまくいかせなかったか…
Enemy_StgLose_011	と…{r[とくしゅ]}特殊{/r}とは…{r[とくしゅ]}特殊{/r}レーンである\nことがバレてしまったか…
Enemy_StgLose_012	む… {r[むねん]}無念{/r}……\n{r[わ]}我{/r}が{r[しょうたい]}小隊{/r}でも{r[と]}止{/r}められなかったか…
Enemy_StgLose_013	{r[ま]}負{/r}けるなんてウソだーーーーっ！\n{r[ていこくぐん]}帝国軍{/r}に{r[にゅうたい]}入隊{/r}したっていうのに…
Enemy_StgLose_014	ブルブルッ…!?\nきゅ、{r[きゅう]}急{/r}に{r[さむ]}寒{/r}くなってきた…
Enemy_StgLose_015	こんな{r[きんにく]}筋肉{/r}の{r[な]}無{/r}いガキに\n{r[ま]}負{/r}けるなんて…
Enemy_StgLose_016	マッチョのなかのマッチョである\nこの{r[わたし]}私{/r}がまさか{r[ま]}負{/r}けるとは…
Enemy_StgLose_017	ぐぬう…！ {r[わたし]}私{/r}は{r[たいちょう]}隊長{/r}だぞ!?\nマッチョ{r[たいちょう]}隊長{/r}なんだぞッ!?
Enemy_StgLose_018	うう… ちくしょーーーっ！\nクビになっちゃうじゃないかーー！
Enemy_StgLose_019	ぬぬ… スシシャッフラーを\n{r[の]}乗{/r}りこえたっていうのか……
Enemy_StgLose_020	スシライカー ムサシ…\nそう… あなたが……
Enemy_StgLose_021	ユーリアがしくじらなければ\nこんなコトにはならなかったのに…
Enemy_StgLose_022	ユーリアが{r[とお]}通{/r}したからオレも\n{r[とお]}通{/r}せってか？ チクショウめ！
Enemy_StgLose_023	ユーリアが{r[あしど]}足止{/r}めできていれば…\nこのことは{r[しょうたいちょう]}小隊長{/r}に{r[ほうこく]}報告{/r}せねば……
Enemy_StgLose_024	く、くそ… ユーリアのせいで\n{r[わ]}我{/r}が{r[たい]}隊{/r}は{r[そうくず]}総崩{/r}れだ……
Enemy_StgLose_025	また{r[わたし]}私{/r}の{r[ま]}負{/r}け…？\nどこからその{r[つよ]}強{/r}さが……
Enemy_StgLose_026	ま、{r[ま]}負{/r}けたあああ…！\n{r[きんにく]}筋肉{/r}がしぼんでいく……
Enemy_StgLose_027	オ、オレの{r[きんにく]}筋肉{/r}は{r[むてき]}無敵{/r}…\nムテキンニクのはずなのに……
Enemy_StgLose_028	{r[きんにく]}筋肉{/r}で　ムサシを{r[と]}止{/r}める\n{r[せき]}責{/r}{r[は]}果{/r}たせず…… ぐふ…
Enemy_StgLose_029	ムサシよ… ぜひ{r[ていこく]}帝国{/r}の\n{r[きんにく]}筋肉{/r}スシライカーにならないか…
Enemy_StgLose_030	{r[なかま]}仲間{/r}… この{r[わたし]}私{/r}が…？\n……ふん、バカみたい…
Enemy_StgLose_031	オ、オレ{r[さま]}様{/r}のバキューム{r[ぐ]}食{/r}いが…\nムサシ… まさかこれほどとは……
Enemy_StgLose_032	ゴホッ…！ のどが{r[は]}腫{/r}れてて\nスシを{r[た]}食{/r}べるのも{r[ひとくろう]}一苦労{/r}だ…
Enemy_StgLose_033	ドライアイで{r[め]}目{/r}が{r[かわ]}乾{/r}いているんだ…\nだからこれは{r[ほんとう]}本当{/r}の{r[じつりょく]}実力{/r}じゃない…
Enemy_StgLose_034	うぅ… {r[はな]}鼻{/r}がつまっていて\nスシの{r[あじ]}味{/r}が{r[わ]}分{/r}からなかった……
Enemy_StgLose_035	{r[あさ]}朝{/r}から{r[あたま]}頭{/r}がフラフラするんだ…\nやはり{r[やす]}休{/r}んだほうがよかったか……
Enemy_StgLose_036	ウヒョ～～！\n{r[きょう]}今日{/r}もキレッキレっすね～♪
Enemy_StgLose_037	ちょっとヤダも～！\nえ～ん、バンブークさま～♪
Enemy_StgLose_038	いた～い\nお{r[ねえ]}姉{/r}さん{r[な]}泣{/r}いちゃうよ？ え～ん
Enemy_StgLose_039	ひゃ～ん\nどうして{r[いた]}痛{/r}いことするの～
Enemy_StgLose_040	どうしよう、{r[ま]}負{/r}けちゃった…\nバンブークさまに{r[おこ]}怒{/r}られちゃう……
Enemy_StgLose_041	そんな～！ スシオケ{r[じごく]}地獄{/r}を\nどうやって{r[の]}乗{/r}り{r[き]}切{/r}ったんだーー!!
Enemy_StgLose_042	ぐう… こんなワサビも\n{r[た]}食{/r}べられないようなガキに……
Enemy_StgLose_043	{r[ま]}負{/r}けちまったか…\nワサビ{r[あい]}愛{/r}が{r[た]}足{/r}りなかったようだ……
Enemy_StgLose_044	ワサビが…\nワサビが{r[た]}足{/r}りねーーー!!
Enemy_StgLose_045	スシがスシである{r[いじょう]}以上{/r}\nワサビは{r[き]}切{/r}っても{r[き]}切{/r}れない… ぐふ…
Enemy_StgLose_046	キョウレツ～！\nやっぱりパないっすね～♪
Enemy_StgLose_047	ちぇ～…\n{r[わたし]}私{/r}の{r[ま]}負{/r}けか～……
Enemy_StgLose_048	あ～あ、{r[わたし]}私{/r}もバンブークさまと\nかくれんぼがしたいな～
Enemy_StgLose_049	むー！ バンブークさまに\nナデナデしてもらうからいいもん！
Enemy_StgLose_050	ムサシちゃんつよいよ～\nおんなのこには{r[やさ]}優{/r}しくね…？
Enemy_StgLose_051	オレの… オレの{r[しゅっせ]}出世{/r}は\nどうなるんだーーー!!!
Enemy_StgLose_052	うぬぬ… {r[やまも]}山盛{/r}りのワサビに\n{r[う]}打{/r}ち{r[か]}勝{/r}つとは、{r[たい]}大{/r}したものじゃ…
Enemy_StgLose_053	くっ… もうじきグロムさまの\n{r[ぶたい]}部隊{/r}が{r[ぞうえん]}増援{/r}に{r[く]}来{/r}るは…ず……
Enemy_StgLose_054	たまたま{r[にがて]}苦手{/r}なスシが\n{r[つづ]}続{/r}いたから{r[ま]}負{/r}けたんだ…！
Enemy_StgLose_055	{r[こども]}子供{/r}だけども{r[ようちゅうい]}要注意{/r}という\n{r[つうたつ]}通達{/r}は{r[ほんとう]}本当{/r}だったのか……
Enemy_StgLose_056	この{r[さき]}先{/r}は{r[つよ]}強{/r}い{r[へい]}兵{/r}がたくさんいる…\n{r[ゆだん]}油断{/r}しないことだな……
Enemy_StgLose_057	ヒョウ♪\nあいかわらずヨイツーですね～♪
Enemy_StgLose_058	ぐおっ！{r[ちょくぞくぶたい]}直属部隊{/r}の{r[わたし]}私{/r}を{r[あいて]}相手{/r}に\nここまでやるとは…！
Enemy_StgLose_059	おのれ… エリート{r[ぶたい]}部隊{/r}の\n{r[わたし]}私{/r}に{r[はじ]}恥{/r}をかかせたな…！
Enemy_StgLose_060	{r[わたし]}私{/r}に{r[か]}勝{/r}ったからと{r[い]}言{/r}って\nいい{r[き]}気{/r}にならないことだな…
Enemy_StgLose_061	エリート{r[しゅうだん]}集団{/r}であるはずの\n{r[わ]}我{/r}が{r[たい]}隊{/r}がまさか{r[ぜんめつ]}全滅{/r}とは…
Enemy_StgLose_062	なんてことだ… {r[ていこくぐん]}帝国軍{/r}{r[とくべつせい]}特別製{/r}の\n{r[でんじほう]}電磁砲{/r}がやぶれるなんて……！
Enemy_StgLose_063	{r[でんじほう]}電磁砲{/r}で{r[あしど]}足止{/r}めできると\n{r[おも]}思{/r}っていたのにーーー！
Enemy_StgLose_064	{r[わたし]}私{/r}は{r[ま]}負{/r}けてしまったが、この{r[ふきん]}付近{/r}の\n{r[あっしゅくじんけい]}圧縮陣形{/r}を{r[き]}切{/r}り{r[ぬ]}抜{/r}けられるかな…
Enemy_StgLose_065	これが{r[かいほうせんせん]}解放戦線{/r}のムサシ…\nなんてうまそうに{r[た]}食{/r}べるんだ……
Enemy_StgLose_066	くっ… ここを{r[とっぱ]}突破{/r}しても\nこの{r[さき]}先{/r}の{r[でんじほう]}電磁砲{/r}がお{r[まえ]}前{/r}を{r[はば]}阻{/r}む…！
Enemy_StgLose_067	グロムさま、{r[もう]}申{/r}し{r[わけ]}訳{/r}ありません…\nこの{r[でんじほう]}電磁砲{/r}も{r[とっぱ]}突破{/r}されました……
Enemy_StgLose_068	ぐ… お{r[まえ]}前{/r}を{r[たお]}倒{/r}してスシパーティで\n{r[しゅくはい]}祝杯{/r}をあげる{r[よてい]}予定{/r}だったのに……
Enemy_StgLose_069	ちくしょう… {r[ようつう]}腰痛{/r}さえなければ\nこんなやつ{r[らくしょう]}楽勝{/r}なのに……
Enemy_StgLose_070	オレだってスシが{r[だいす]}大好{/r}きなのに\n{r[ま]}負{/r}けちまったか……
Enemy_StgLose_071	…きっと{r[ておく]}手遅{/r}れだムサシよ……\nグロムさまはもう{r[もど]}戻{/r}られたはず…
Enemy_StgLose_072	ほう… ゴウライ{r[あいて]}相手{/r}にここまで…\nこれは{r[うれ]}嬉{/r}しい{r[ごさん]}誤算{/r}というものだ
Enemy_StgLose_073	そんな…！ {r[てっていてき]}徹底的{/r}に{r[ごうりせい]}合理性{/r}を\n{r[ついきゅう]}追求{/r}したスタイルのはずなのに……
Enemy_StgLose_074	スシ{r[かいほうせんせん]}解放戦線{/r}が\nよもやここまで{r[せま]}迫{/r}っているとは…
Enemy_StgLose_075	お{r[まえ]}前{/r}がムサシか…\n{r[しょうしょう]}少々{/r}あなどっていたようだ……
Enemy_StgLose_076	た、たのむ…！\nトドメだけは{r[ゆる]}許{/r}してくれ…!!
Enemy_StgLose_077	こ、これが…\n{r[はいぼく]}敗北{/r}の{r[あじ]}味{/r}…か……
Enemy_StgLose_078	ワオッ！\nシースーのムーゲーお{r[じょうず]}上手{/r}ですね！
Enemy_StgLose_079	{r[ま]}負{/r}けたからおじょうさまに\n{r[しか]}叱{/r}られてしまう…… うふふ…♪
Enemy_StgLose_080	ああ… おじょうさま……\n{r[ま]}負{/r}けた{r[わたし]}私{/r}を{r[しか]}叱{/r}ってください……
Enemy_StgLose_081	よおおおし{r[ま]}負{/r}けたあああ！\nこれで{r[しか]}叱{/r}ってもらえるぞ!!
Enemy_StgLose_082	ふふ… おじょうさまに\n{r[しか]}叱{/r}ってもらうために{r[ま]}負{/r}けたのですよ
Enemy_StgLose_083	そんな～！ オレのコンボウォールを\nまさか{r[の]}乗{/r}り{r[こ]}越{/r}えられるなんてーー！
Enemy_StgLose_084	{r[あか]}赤{/r}いスシを{r[た]}食{/r}べると{r[しか]}叱{/r}られる…\n{r[あか]}赤{/r}いスシを{r[た]}食{/r}べると{r[しか]}叱{/r}られる…
Enemy_StgLose_085	ソスナ{r[さま]}様{/r}もうしわけありません…\nやはり{r[あか]}赤{/r}いスシは{r[つよ]}強{/r}かったです……
Enemy_StgLose_086	や、やはり{r[あか]}赤{/r}いスシも{r[た]}食{/r}べないと\nチカラが、で… {r[で]}出{/r}ない……
Enemy_StgLose_087	ぬおっ！？\nめ、{r[め]}目{/r}の{r[まえ]}前{/r}に{r[あか]}赤{/r}いスシが……
Enemy_StgLose_088	シースー　マイウー！\nガトアリでした～♪
Enemy_StgLose_089	おじょうさまのスイーツタイムを\n{r[じゃま]}邪魔{/r}させる…わけには……
Enemy_StgLose_090	おじょうさまのエステタイム…\n{r[ほんとう]}本当{/r}は{r[わたし]}私{/r}も{r[どうせき]}同席{/r}したいのだッ…！
Enemy_StgLose_091	わ、わたしだって{r[ほんとう]}本当{/r}は…\n{r[あか]}赤{/r}いスシを{r[た]}食{/r}べたいんです……
Enemy_StgLose_092	お、おみごと…\nあなたならソスナさまを……
Enemy_StgLose_093	オレになんのうらみが\nあるんだーーっ！ うわーーん!!
Enemy_StgLose_094	ちっ… ヒカリノコロモが\nまさかやぶられるなんてね……
Enemy_StgLose_095	この{r[さき]}先{/r}に{r[すす]}進{/r}んだとしても\n{r[ゆき]}雪{/r}だるまになるだけだぞ…！
Enemy_StgLose_096	{r[ま]}負{/r}けたので、さっさと{r[もど]}戻{/r}って\n{r[あたた]}暖{/r}まろうと{r[おも]}思{/r}うのである!!
Enemy_StgLose_097	{r[さむ]}寒{/r}いし、ムサシには{r[ま]}負{/r}けるし！\nなんなんだ{r[きょう]}今日{/r}は!!
Enemy_StgLose_098	{r[さむ]}寒{/r}さには{r[ま]}負{/r}けなかったのに\nムサシに{r[ま]}負{/r}けたーーー!!
Enemy_StgLose_099	こんな{r[さむ]}寒{/r}い{r[ち]}地{/r}にまで{r[き]}来{/r}て\nまたも、ひねりつぶされるなんて～
Enemy_StgLose_100	さっきまでなんともなかったのに\n{r[きゅう]}急{/r}に{r[さむ]}寒{/r}くなったように{r[かん]}感{/r}じる……
Enemy_StgLose_101	す、すこしは{r[きんにく]}筋肉{/r}が\n{r[つ]}付{/r}いたようだな……
Enemy_StgLose_102	マッチョのなかのマッチョである\n{r[わたし]}私{/r}がまたもや{r[ま]}負{/r}けるとは……
Enemy_StgLose_103	マッチョ{r[ぶたい]}部隊{/r}をまたも{r[やぶ]}破{/r}るとは\nムサシ、お{r[まえ]}前{/r}こそ{r[しん]}真{/r}のマッチョだ！
Enemy_StgLose_104	お{r[まえ]}前{/r}が「もと」とか{r[い]}言{/r}うから\n{r[き]}気{/r}が{r[ぬ]}抜{/r}けてしまったではないか…
Enemy_StgLose_105	くそーー!! ワサビの{r[くんれん]}訓練{/r}を\n{r[う]}受{/r}けたのに、また{r[ま]}負{/r}けたーーー!!
Enemy_StgLose_106	ムサシにまた{r[ま]}負{/r}けた…\nああ… また{r[きんにく]}筋肉{/r}がしぼんでいく……
Enemy_StgLose_107	{r[むてき]}無敵{/r}の{r[きんにく]}筋肉{/r}ムテキンニクも\nもはやここまでか……
Enemy_StgLose_108	スシライカー {r[じつ]}実{/r}は{r[きんにく]}筋肉{/r}\n{r[かんけい]}関係{/r}ない？ ……ぐふ…
Enemy_StgLose_109	{r[なんど]}何度{/r}でもスカウトするぞムサシ！\n{r[きんにく]}筋肉{/r}スシライカーにならないか…？
Enemy_StgLose_110	{r[しんにゅうしゃ]}侵入者{/r}を{r[はいじょ]}排除{/r}するつもりが\n{r[わたし]}私{/r}が{r[はいじょ]}排除{/r}されてしまうとは…
Enemy_StgLose_111	バ、バキューム{r[りょく]}力{/r}が{r[た]}足{/r}りねえ…\nもっと… もっとプロテインを……
Enemy_StgLose_112	よくぞ{r[わたし]}私{/r}を{r[たお]}倒{/r}した…\nだが{r[わたし]}私{/r}はこの{r[ぶたい]}部隊{/r}の{r[なか]}中{/r}でも{r[さいじゃく]}最弱{/r}……
Enemy_StgLose_113	やぶれてしまったが、まあ{r[とうぜん]}当然{/r}か…\nだってボクは{r[ぶたい]}部隊{/r}の{r[なか]}中{/r}で{r[さいじゃく]}最弱{/r}だし…
Enemy_StgLose_114	{r[とっぱ]}突破{/r}されたけど、しかたないか…\nなぜってオレは{r[ぶたい]}部隊{/r}で{r[さいじゃく]}最弱{/r}だし……
Enemy_StgLose_115	{r[ま]}負{/r}けたか… なんたって{r[たいちょう]}隊長{/r}のオレが\n{r[いちばん]}一番{/r}{r[よわ]}弱{/r}いから、しかたないよな……
Enemy_StgLose_116	ムサシさんとのシースーのムーゲー\n{r[まいかい]}毎回{/r}チョー{r[たの]}楽{/r}しいっす～♪
Enemy_StgLose_117	オレはやられてしまったが\n{r[つぎ]}次{/r}のルツコイは{r[つよ]}強{/r}いぞ……
Enemy_StgLose_118	ま、{r[ま]}負{/r}けた… だがこの{r[おく]}奥{/r}の\nマツイが{r[か]}勝{/r}ってくれるはずだ…
Enemy_StgLose_119	ぐぬ… やぶれてしまうとは…\nあとは{r[たいちょう]}隊長{/r}に{r[まか]}任{/r}せるとしよう……
Enemy_StgLose_120	{r[たいちょう]}隊長{/r}のオレが{r[ま]}負{/r}けた{r[ばあい]}場合{/r}\n{r[つぎ]}次{/r}は{r[だれ]}誰{/r}を{r[たよ]}頼{/r}ればいいんだ…
Enemy_StgLose_121	た、たいちょ～…\n{r[でんじほう]}電磁砲{/r}、{r[とっぱ]}突破{/r}されました～……
Enemy_StgLose_122	{r[ま]}負{/r}けた… アブリコス{r[たい]}隊{/r}みたいに\nマッチョ{r[ろせん]}路線{/r}に{r[か]}変{/r}えてみようかな…
Enemy_StgLose_123	くっ… バンブーク{r[たい]}隊{/r}のように\nワサビで{r[せ]}攻{/r}めればよかったか…
Enemy_StgLose_124	うう… ソスナ{r[たい]}隊{/r}みたいに{r[あか]}赤{/r}いスシを\n{r[せいげん]}制限{/r}するスタイルなら{r[か]}勝{/r}てたかな…
Enemy_StgLose_125	ぐぬっ… やはりグロム{r[たい]}隊{/r}のような\nエレガントさが{r[た]}足{/r}りないのか……
Enemy_StgLose_126	みごとな「スシ{r[すじ]}筋{/r}」です…\nさすがは… グロムさまの……
Enemy_StgLose_127	スシに{r[ささ]}捧{/r}げた{r[わ]}我{/r}が{r[しんねん]}信念{/r}…\nグロムさまとともにありッ！
Enemy_StgLose_128	グロムさまの{r[ちすじ]}血筋{/r}が{r[つく]}作{/r}りだす\n「スシ{r[すじ]}筋{/r}」がこれほど{r[うつく]}美{/r}しいとは…
Enemy_StgLose_129	{r[われ]}我{/r}ら{r[せいえいぶたい]}精鋭部隊{/r}をも{r[あっとう]}圧倒{/r}するとは…\n{r[まよ]}迷{/r}いの{r[な]}無{/r}い「スシ{r[すじ]}筋{/r}」……
Enemy_StgLose_130	もはや{r[でんじほう]}電磁砲{/r}ごときでは\nムサシさまは{r[と]}止{/r}められない…か…
Enemy_StgLose_131	ムサシ… よくぞ{r[ちち]}父{/r}を{r[う]}打{/r}ち{r[たお]}倒{/r}した…\nまさかお{r[まえ]}前{/r}にスシを{r[おそ]}教{/r}わるとはな…
Enemy_StgLose_132	ムサシ…\nココマデ ヤッテ{r[く]}来{/r}ルナンテ……
Enemy_StgLose_133	トマレ ムサシ…\nコノ{r[さき]}先{/r}ハ {r[い]}行{/r}キ{r[ど]}止{/r}マリダ……
Enemy_StgLose_134	ココヲ {r[まも]}守{/r}レナカッタ…\nココヲ {r[まも]}守{/r}レナカッタ… ココヲ…
Enemy_StgLose_135	グラードサマ {r[もう]}申{/r}シ{r[わけ]}訳{/r}アリマセン\n{r[しったい]}失態{/r}ハ コノ{r[み]}身{/r}デ……
Enemy_StgLose_136	ムサシさんとパイセンのコンビ\nマジでパないっすね～！！
Enemy_StgLose_137	{r[こども]}子供{/r}ノ クセニ\n{r[ず]}図{/r}ニ{r[の]}乗{/r}リオッテ……
Enemy_StgLose_138	ソノ {r[ちい]}小{/r}サナ {r[からだ]}体{/r}ノ\nドコニ ソンナチカラガ…
Enemy_StgLose_139	アア… グラードサマノ\nスシ{r[ほかんけいかく]}補完計画{/r}ガ {r[くず]}崩{/r}レテユク…
Enemy_StgLose_140	グラードサマノ トコロマデ\n{r[すす]}進{/r}マレル ワケニハ……
Enemy_StgLose_141	オ、オノレ… {r[ていこく]}帝国{/r}デ スシヲ\n{r[どくせん]}独占{/r}スル {r[けいかく]}計画{/r}ガ……
Enemy_StgLose_142	{r[ふかく]}不覚{/r}… ジュウベエニモ\n{r[さき]}先{/r}ニ {r[い]}行{/r}カレテ シマッタ…
Enemy_StgLose_143	ナゼダ… スシヲ タラフク{r[た]}食{/r}ベル\n{r[しこう]}至高{/r}ノ{r[みらい]}未来{/r}ガ アルハズナノニ…
Enemy_StgLose_144	グラード… サマ… ニハ…\n{r[いっぽ]}一歩{/r}モ…… {r[ちか]}近{/r}ヅカセ…… ン……
Enemy_StgLose_145	どうして… スシはボクのもの…\nキミのスシもボクのもののはず……
Enemy_StgLose_146	なぜ… なぜキミは{r[わら]}笑{/r}って…\n{r[わら]}笑{/r}ってスシを{r[た]}食{/r}べるんだ……
Enemy_StgLose_197	うぐっ… キサマからその{r[いし]}石{/r}を\n{r[うば]}奪{/r}うことさえできれば……
Enemy_StgLose_198	いしを… ゆずってくれるという\n{r[いし]}意思{/r}は… ないのか……
Enemy_StgLose_199	ぬう… このままでは{r[れい]}例{/r}の{r[じんじゃ]}神社{/r}まで\nたどり{r[つ]}着{/r}かれてしまう…
Enemy_StgLose_200	いったいどこからこの{r[さき]}先{/r}の{r[じんじゃ]}神社{/r}の\n{r[じょうほう]}情報{/r}を{r[き]}聞{/r}きつけてきたんだ…
Enemy_StgLose_201	{r[わ]}我{/r}がマッチョをもろともしない…\nまさかキサマが{r[しん]}真{/r}のマッチョ!?
Enemy_StgLose_202	マッチョ～マッチョ～{r[たいそう]}体操{/r}～♪\nさあムサシくんも{r[いっしょ]}一緒{/r}に!!
Enemy_StgLose_203	{r[たいちょう]}隊長{/r}におまえが{r[ぶたい]}部隊{/r}で{r[いちばん]}一番{/r}{r[つよ]}強{/r}いと\n{r[い]}言{/r}ってもらったのに、{r[ま]}負{/r}けるとは…
Enemy_StgLose_204	{r[ぶたい]}部隊{/r}で{r[さいきょう]}最強{/r}の{r[へい]}兵{/r}は{r[わたし]}私{/r}だと{r[たいちょう]}隊長{/r}に\n{r[い]}言{/r}ってもらえたのに、ちくしょう…
Enemy_StgLose_205	{r[たいちょう]}隊長{/r}から{r[ぶたいさいきょうへいし]}部隊最強兵士{/r}の{r[しょうごう]}称号{/r}を\nもらったのに、{r[ま]}負{/r}けるなんて…
Enemy_StgLose_206	ほめて{r[の]}伸{/r}ばした{r[ぶか]}部下{/r}たちは{r[ぜんめつ]}全滅{/r}か…\nだがギアは{r[われわれ]}我々{/r}{r[ていこく]}帝国{/r}の{r[て]}手{/r}に……
Enemy_StgLose_209	このあたりは{r[けいび]}警備{/r}も{r[げんじゅう]}厳重{/r}だ…\nキサマに{r[き]}切{/r}り{r[ぬ]}抜{/r}けられるかな……
Enemy_StgLose_210	なぜ{r[ていこく]}帝国{/r}のこんな{r[おくち]}奥地{/r}に{r[あらわ]}現{/r}れた…\nまさか{r[はつめい]}発明{/r}のウワサは{r[ほんとう]}本当{/r}なのか…
Enemy_StgLose_211	ぐっ… キサマまさか\nこの{r[さき]}先{/r}の{r[ぐんじしせつ]}軍事施設{/r}に……
Enemy_StgLose_212	ぐぬうっ… {r[ていこく]}帝国{/r}の{r[いだい]}偉大{/r}な{r[はつめい]}発明{/r}を\n{r[じゃま]}邪魔{/r}されるわけには……
Enemy_StgLose_213	{r[たいちょう]}隊長{/r}におまえは{r[ぶたい]}部隊{/r}で{r[さいじゃく]}最弱{/r}だと\n{r[い]}言{/r}われ、{r[じぶん]}自分{/r}なりに{r[がんば]}頑張{/r}ったんだ…
Enemy_StgLose_214	{r[わたし]}私{/r}が{r[ぶたい]}部隊{/r}で{r[いちばん]}一番{/r}{r[よわ]}弱{/r}いと{r[たいちょう]}隊長{/r}に{r[い]}言{/r}われ\n{r[ひっし]}必死{/r}に{r[く]}食{/r}らいついていたんだ…
Enemy_StgLose_215	{r[ぶたいさいじゃくへいし]}部隊最弱兵士{/r}の{r[しょうごう]}称号{/r}を{r[たいちょう]}隊長{/r}に{r[さず]}授{/r}かり\n{r[おめいへんじょう]}汚名返上{/r}のつもりで{r[ふんとう]}奮闘{/r}したのに…
Enemy_StgLose_216	{r[しり]}尻{/r}をたたいて{r[そだ]}育{/r}てた{r[ぶか]}部下{/r}は{r[ぜんめつ]}全滅{/r}か…\n{r[ほんとう]}本当{/r}は{r[わたし]}私{/r}が{r[いちばん]}一番{/r}{r[よわ]}弱{/r}かったのかもな…
Enemy_StgLose_217	{r[でんじほう]}電磁砲{/r}まで{r[とっぱ]}突破{/r}されてしまった…\n{r[しせつ]}施設{/r}に{r[せ]}攻{/r}め{r[こ]}込{/r}まれてしまう……
Enemy_StgLose_218	くそう… {r[じっけんそうち]}実験装置{/r}まで{r[こわ]}壊{/r}されて\nこの{r[しせつ]}施設{/r}の{r[そんぞく]}存続{/r}が……
Enemy_StgLose_219	マ、マサカ… {r[ほんとう]}本当{/r}にチカラずくで\nギアをうばわれる…… ナンテ……
Enemy_StgLose_221	レアスシガミはトップシークレット\nキサマに{r[おし]}教{/r}えたりなど……
Enemy_StgLose_222	この{r[さき]}先{/r}にはなにも{r[な]}無{/r}いぞ…！\n{r[たの]}頼{/r}むから{r[ひ]}引{/r}き{r[かえ]}返{/r}してくれえぇ！
Enemy_StgLose_223	ここを{r[とお]}通{/r}してしまったら{r[たいちょう]}隊長{/r}に\nしかられてしまうではないか…
Enemy_StgLose_224	くっ… ゴクオウとの\n{r[けいやく]}契約{/r}の{r[さら]}皿{/r}をやられちまうとは…
Enemy_StgLose_225	きゃう～ん…\n{r[いた]}痛{/r}い{r[め]}目{/r}にあわされちゃった…
Enemy_StgLose_226	ううう… スシバトルよりも\nおねえさんと{r[うみ]}海{/r}で{r[あそ]}遊{/r}ぼうよう？
Enemy_StgLose_227	え～ん… この{r[さき]}先{/r}には{r[だれ]}誰{/r}も{r[とお]}通{/r}すな\nって{r[たいちょう]}隊長{/r}に{r[い]}言{/r}われてたのに～
Enemy_StgLose_228	ぶんどりシールドを{r[の]}乗{/r}り{r[き]}切{/r}るなんて\nムサシちゃん、{r[おそ]}恐{/r}ろしい{r[こ]}子{/r}…！
Enemy_StgLose_233	おじょうさまからのせっかくの\nご{r[めいれい]}命令{/r}を{r[すいこう]}遂行{/r}できないなんて…
Enemy_StgLose_234	バトルに{r[ま]}負{/r}けようとも、{r[あか]}赤{/r}いスシは\n{r[た]}食{/r}べないのがソスナ{r[たい]}隊{/r}のスタイル…
Enemy_StgLose_235	{r[われわれ]}我々{/r}がバトルで{r[じかん]}時間{/r}をかせげば\nおじょうさまはエステに{r[い]}行{/r}ける…
Enemy_StgLose_236	そ、そんな… {r[ほんとう]}本当{/r}に\nおじょうさまはもうここには……
Enemy_StgLose_237	うう… ここへの{r[みち]}道{/r}はソスナさまの\n{r[ぶたい]}部隊{/r}が{r[ふうさ]}封鎖{/r}していたはずなのに……
Enemy_StgLose_238	この{r[さき]}先{/r}に… この{r[さき]}先{/r}に{r[すす]}進{/r}ませる\nわけにはいかないんだあああ…！
Enemy_StgLose_239	あっちで{r[ふしぎ]}不思議{/r}な{r[い]}生{/r}き{r[もの]}物{/r}を{r[み]}見{/r}たぞ！\n{r[い]}行{/r}ってみたらどうだ!?
Enemy_StgLose_240	くっ… {r[でおく]}出遅{/r}れたうえに\nスシバトルにも{r[ま]}負{/r}けてしまうとは…
Enemy_StgLose_249	ぐっ… さすがの{r[つよ]}強{/r}さだ…\nスシガミはどうだ…？
Enemy_StgLose_250	これだけ{r[はで]}派手{/r}にスシバトルをすれば\nスシガミもひょっこり{r[あらわ]}現{/r}れるはず…
Enemy_StgLose_251	スシガミを{r[よ]}呼{/r}ぶためとは{r[い]}言{/r}え\n{r[れんせんれんしょう]}連戦連勝{/r}の{r[かいしんげき]}快進撃{/r}はさすがだな…
Enemy_StgLose_252	{r[ゆくえふめい]}行方不明{/r}のスシガミを{r[み]}見{/r}つけたのに\n{r[かんじん]}肝心{/r}のスシバトルで{r[ま]}負{/r}けるとは…
Enemy_StgLose_253	なぜだムサシ…\nなぜこの{r[さき]}先{/r}に{r[すす]}進{/r}もうとする……
Enemy_StgLose_254	うっかりしゃべってしまったのが\n{r[うん]}運{/r}の{r[つ]}尽{/r}きだったか……
Enemy_StgLose_255	スシガミがいそうなところには\nどこにでも{r[あらわ]}現{/r}れるなムサシ…
Enemy_StgLose_256	うう… {r[さむ]}寒{/r}い{r[さむ]}寒{/r}い……\nこの{r[さむ]}寒{/r}さにうんざりしていたんだ…
Enemy_StgLose_257	この{r[ゆき]}雪{/r}でほこらも{r[う]}埋{/r}もれている…\nキサマに{r[み]}見{/r}つけられるかな……
Enemy_StgLose_258	くうっ… キサマが{r[み]}見{/r}つけたほこらだ\nキサマの{r[す]}好{/r}きにしたらいい……
Enemy_StgLose_259	{r[ひさびさ]}久々{/r}のスシバトルだったが…\nやはり{r[うで]}腕{/r}がなまっていたか…！
Enemy_StgLose_260	{r[まいにち]}毎日{/r}あまりにも{r[ひま]}暇{/r}すぎる{r[わ]}我{/r}が{r[たい]}隊{/r}は\n{r[み]}身{/r}を{r[かく]}隠{/r}す{r[くんれん]}訓練{/r}が{r[はや]}流行{/r}っているのだ…
Enemy_StgLose_261	ぐっ… こんなところで{r[たお]}倒{/r}れたら\nオニに{r[み]}見{/r}つかるではないか……
Enemy_StgLose_262	もっ、も～い～か～い…\nぐふッ…ダメだ…{r[おお]}大{/r}きい{r[こえ]}声{/r}が{r[で]}出{/r}ぬ…
Enemy_StgLose_263	あたしがスカッとしたいのに\nキミにスカッとされちゃうなんて…
Enemy_StgLose_264	{r[つよ]}強{/r}いねえ…キミとバトルをすると\nボクの{r[きんにく]}筋肉{/r}も{r[きょうめい]}共鳴{/r}するようだよ！！
Enemy_StgLose_265	のどかな{r[ふうけい]}風景{/r}と{r[あせ]}汗{/r}がしたたる{r[きんにく]}筋肉{/r}…\nみごとな{r[ちょうわ]}調和{/r}だと{r[おも]}思{/r}わないかね！？
Enemy_StgLose_266	ほこらの{r[ちょうさ]}調査{/r}もしないとだけど\n{r[きん]}筋{/r}トレを{r[ゆうせん]}優先{/r}しちゃうんだよね！！
Enemy_StgLose_267	ぐおっ…ただでさえ{r[きんにく]}筋肉{/r}が１{r[めい]}名{/r}\n{r[ゆくえふめい]}行方不明{/r}で{r[たいへん]}大変{/r}だというのに……
Enemy_StgLose_268	{r[わたし]}私{/r}はスシとマッチョを{r[きわ]}極{/r}め…\n……ん？ オ、オレはなにを……
Enemy_StgLose_269	なぜだムサシ… なぜ{r[われわれ]}我々{/r}を\n{r[たお]}倒{/r}してまで{r[すす]}進{/r}もうとする……
Enemy_StgLose_270	やんちゃなだけではないようだな…\nいいだろう、ここはゆずってやる
Enemy_StgLose_271	ギギ…カメレサツノ　チカラガ\nマケルナンテ…
Enemy_StgLose_272	ほう？　{r[みちが]}見違{/r}えるようなスシ{r[すじ]}筋{/r}…\nなにがあったのか{r[きょうみ]}興味{/r}がありますね
Enemy_StgLose_273	はう～ん…ひっど～い！！\nおねえさん{r[いた]}痛{/r}いのはキライよ？
Enemy_StgLose_274	なんだかチョ～{r[つよ]}強{/r}くないですか？\nムサシさん{r[ひとかわ]}一皮{/r}むけちゃいました？
Enemy_StgLose_275	{r[き]}聞{/r}いてないぞムサシ！\nいつの{r[ま]}間{/r}にこんなに{r[つよ]}強{/r}くなった！！
Enemy_StgLose_276	なっ…なぜ{r[ま]}負{/r}けた！？\nさっそく{r[はいいん]}敗因{/r}を{r[ぶんせき]}分析{/r}しなくては…！
Enemy_StgLose_277	オレ{r[さま]}様{/r}の{r[きんにく]}筋肉{/r}が{r[つう]}通{/r}じねえだと！？\nお{r[まえ]}前{/r}かなり{r[きた]}鍛{/r}えているじゃねえか…
Enemy_StgLose_278	ずいぶん{r[つよ]}強{/r}くなったじゃないか\nあんなにお{r[こさま]}子様{/r}だったってのにね
Enemy_StgLose_279	マ、マントガ　メクレテシマウ…\n{r[み]}見{/r}ルナ！　マントノ{r[なか]}中{/r}ヲ{r[み]}見{/r}ルナ…！
Enemy_StgLose_280	{r[か]}勝{/r}ったからなんだっていうの…？\n{r[せんそう]}戦争{/r}なんてなにも{r[う]}生{/r}まないのに…
Enemy_StgLose_281	ボクの{r[ま]}負{/r}け…？\nもっとスシが{r[た]}食{/r}べたいな…
Enemy_StgLose_282	むむっ？　{r[わたし]}私{/r}のヒラメ{r[きん]}筋{/r}が\nムサシくんに{r[ま]}負{/r}けただと…！？
Enemy_StgLose_283	スシライカーのムサシか…\n{r[い]}良{/r}い{r[め]}目{/r}をしているな。フッフッフ…
Enemy_StgLose_284	ワサビの{r[みりょく]}魅力{/r}に{r[き]}気{/r}づいて\n{r[おとな]}大人{/r}に{r[ちか]}近{/r}づいとるようじゃのう…！
Enemy_StgLose_285	{r[わか]}若{/r}き{r[ひ]}日{/r}のグロムさまを\nほうふつとさせるスシ{r[すじ]}筋{/r}…みごと…
Enemy_StgLose_286	バカな！　{r[ていこく]}帝国{/r}の{r[ひみつへいき]}秘密兵器{/r}が\nこうもあっさりとやぶられるとは…
Enemy_StgLose_287	ちょっといきなりなんなのよ！\nえっ…あなたもムサシって{r[なまえ]}名前{/r}！？
Enemy_StgLose_288	ムサシちゃんとはこの{r[まえ]}前{/r}も\nたたかった{r[き]}気{/r}がするけど{r[き]}気{/r}のせい？
Enemy_StgLose_289	ぐ…{r[かいほうせんせん]}解放戦線{/r}に{r[かえ]}返{/r}り{r[ざ]}咲{/r}くつもりが\nよもや{r[て]}手{/r}も{r[あし]}足{/r}も{r[で]}出{/r}ないとは……
Enemy_StgLose_290	ずいぶんと{r[つよ]}強{/r}くなったじゃねえか！\nスシも{r[だいじ]}大事{/r}だが{r[きんにく]}筋肉{/r}も{r[きた]}鍛{/r}えろよ！！
Enemy_StgLose_291	オーノー…こんなていたらくでは\nおじょうさまに{r[しか]}叱{/r}られてしまう……
Enemy_StgLose_292	ちょっと{r[ま]}待{/r}って{r[ま]}待{/r}ってえええ！！\n{r[さら]}皿{/r}をそんなに{r[な]}投{/r}げてズルいぞ！！
Enemy_StgLose_293	さすがはオレの{r[こ]}子{/r}だ\nスシ{r[すじ]}筋{/r}にいっさいの{r[まよ]}迷{/r}いが{r[な]}無{/r}い
Enemy_StgLose_294	グギギ…　{r[な]}投{/r}ゲラレタ{r[さら]}皿{/r}デ\n{r[かめん]}仮面{/r}ガ　{r[わ]}割{/r}レルカト　{r[おも]}思{/r}ッタゾ…
Enemy_StgLose_295	ワサビも{r[た]}食{/r}べられんこわっぱだと\n{r[しょうしょう]}少々{/r}あなどっていたようじゃな…
Enemy_StgLose_296	ガトアリでした～♪\nムサシさん、キレがグンバツっす♪
Enemy_StgLose_297	おっとっと…{r[むないた]}胸板{/r}が{r[あつ]}厚{/r}すぎて\n{r[てもと]}手元{/r}が{r[み]}見{/r}えなかったぜ…！
Enemy_StgLose_298	{r[あか]}赤{/r}いスシでアタイにたてついて\n{r[いや]}嫌{/r}がらせのつもりかいっ…！
Enemy_StgLose_299	{r[じつりょく]}実力{/r}はたしかなようね…\nあなたの{r[すす]}進{/r}む{r[さき]}先{/r}…{r[み]}見{/r}せてもらうわ…
Enemy_StgLose_300	{r[わたし]}私{/r}を{r[おこ]}怒{/r}らせてしまったようだな…\nグロムさまに{r[しゅつじんねが]}出陣願{/r}わねば…
Enemy_StgLose_301	お{r[さら]}皿{/r}じゃなくてスシを{r[な]}投{/r}げてよ\nもっとスシを{r[た]}食{/r}べたいんだから…
Enemy_StgLose_302	いきなりなんなんだ！\nえっ…お{r[まえ]}前{/r}もムサシって{r[なまえ]}名前{/r}！？
Enemy_StgLose_C_001	くっ…{r[しま]}島{/r}のスシガミたちが\nまさかムサシの{r[みかた]}味方{/r}をするとは…
Enemy_StgLose_C_002	なんなんだ、この{r[しま]}島{/r}のスシガミは…\nネタをだっこしている…だと…
Enemy_StgLose_C_003	ネタをだっこするスシガミ…\n{r[なづ]}名付{/r}けて、ネタガミ…でどうだ！
Enemy_StgLose_C_004	なぜネタをだっこしているんだ…！\n{r[き]}気{/r}になってバトルに{r[しゅうちゅう]}集中{/r}できん…
Enemy_StgLose_C_005	クッ…コノママ{r[すす]}進{/r}マレルト　{r[おく]}奥{/r}ノ\n{r[ほこら]}祠{/r}ニイルトイウ　スシガミガ…
Enemy_StgLose_C_006	な…なぜそのスシガミはネタを\nずっとだっこし{r[つづ]}続{/r}けているのだ…
Enemy_StgLose_C_007	そのスシガミ…よく{r[み]}見{/r}ると\nぷるぷる{r[ふる]}震{/r}えている…？
Enemy_StgLose_C_008	なぜそのスシガミはマッチョの\n{r[わたし]}私{/r}ではなくキミを{r[えら]}選{/r}んだのだ…！？
Enemy_StgLose_C_009	そのキュートなスシガミたち、\nマッチョな{r[わたし]}私{/r}を{r[けいかい]}警戒{/r}している…？
Enemy_StgLose_C_010	{r[しま]}島{/r}ノ{r[おく]}奥{/r}ノ　{r[ほこら]}祠{/r}ニダケハ…\n{r[ちか]}近{/r}ヅカセル　ワケニハ…
Enemy_StgLose_C_011	この{r[しま]}島{/r}のスシガミ{r[ちょう]}超{/r}かわいい～♪\nもうバトルとかどうでもいいし～
Enemy_StgLose_C_012	スシガミかわいい～！ネタよりも\nおねえさんをだっこして～♪
Enemy_StgLose_C_013	え～ん…！こんなラブリーな\nスシガミを{r[こうげき]}攻撃{/r}するなんてムリ～！
Enemy_StgLose_C_014	やだっ！スシガミの！プリティな！\n{r[すがた]}姿{/r}に！{r[こころ]}心{/r}が！{r[みだ]}乱{/r}されちゃう…っ！
Enemy_StgLose_C_015	グウッ…　{r[おく]}奥{/r}ニアル　{r[ほこら]}祠{/r}ニハ\nナントシテモ　{r[ていこく]}帝国{/r}ガ　{r[さき]}先{/r}ニ…
Enemy_StgLose_C_016	ぐうう…。あの{r[あい]}愛{/r}らしいスシガミと\n{r[たたか]}戦{/r}うなんて…オレには…できねえ…
Enemy_StgLose_C_017	そのスシガミ…のんびり{r[や]}屋{/r}に{r[み]}見{/r}えて\nバトルであれほど{r[すばや]}素早{/r}く{r[うご]}動{/r}くとは…
Enemy_StgLose_C_018	ここのスシガミたちを{r[み]}見{/r}ていると\nなにかをだっこしたくなってくる…
Enemy_StgLose_C_019	ムサシめ…{r[みち]}未知{/r}のスシガミとすら\n{r[こころ]}心{/r}を{r[つう]}通{/r}じ{r[あ]}合{/r}わせてしまうとは…
Enemy_StgLose_C_020	ソンナ…　{r[われわれ]}我々{/r}ノ　{r[ひがん]}悲願{/r}デモアル\n{r[ゆめ]}夢{/r}ノ{r[けいかく]}計画{/r}ガ　コンナトコロデ…
Enemy_StgLose_C_021	な…なぜ、ムサシとスシガミたちは\nそこまで{r[つう]}通{/r}じ{r[あ]}合{/r}っているんだ…！？
Enemy_StgLose_C_022	スシガミたちよ…{r[ていこく]}帝国{/r}に{r[き]}来{/r}たら\nネタをたくさんだっこできるぞ…！
Enemy_StgLose_C_023	ネタはおんぶじゃダメなのか！？\nだっこのほうが{r[つか]}疲{/r}れそうだぞ…
Enemy_StgLose_C_024	{r[す]}好{/r}きなものはぎゅっと{r[だ]}抱{/r}きしめたく\nなるよな！わかるぞスシガミたちよ
Enemy_StgLose_C_025	…くそっ！この{r[しま]}島{/r}の{r[しょうあく]}掌握{/r}は\n{r[ふかのう]}不可能{/r}と{r[はんだん]}判断{/r}！{r[そういんてったい]}総員撤退{/r}だッ…！
EnemyTitle_001	偵察隊・新人
EnemyTitle_002	偵察隊・指導係
EnemyTitle_003	宿命のライバル？
EnemyTitle_004	強行偵察隊・新人
EnemyTitle_005	強行偵察隊・新人
EnemyTitle_006	強行偵察隊・新人
EnemyTitle_007	強行偵察隊・指導係
EnemyTitle_008	スシ解放戦線リーダー
EnemyTitle_009	戦闘第１０１小隊
EnemyTitle_010	戦闘第１０１小隊
EnemyTitle_011	戦闘第１０１小隊
EnemyTitle_012	戦闘第１０１小隊
EnemyTitle_013	宿命のライバル？？
EnemyTitle_014	アブリコス精鋭第１小隊
EnemyTitle_015	アブリコス精鋭第１小隊
EnemyTitle_016	アブリコス精鋭第１小隊
EnemyTitle_017	アブリコス精鋭第１小隊
EnemyTitle_018	宿命のライバル？？？
EnemyTitle_019	拠点防衛隊
EnemyTitle_020	少女戦士
EnemyTitle_021	国境警備小隊
EnemyTitle_022	国境警備小隊
EnemyTitle_023	国境警備小隊
EnemyTitle_024	国境警備小隊
EnemyTitle_025	少女戦士
EnemyTitle_026	アブリコス精鋭第２小隊
EnemyTitle_027	アブリコス精鋭第２小隊
EnemyTitle_028	アブリコス精鋭第２小隊
EnemyTitle_029	アブリコス精鋭第２小隊
EnemyTitle_030	少女戦士
EnemyTitle_031	ワイルデストスシライカー
EnemyTitle_032	戦闘第４０２小隊
EnemyTitle_033	戦闘第４０２小隊
EnemyTitle_034	戦闘第４０２小隊
EnemyTitle_035	戦闘第４０２小隊
EnemyTitle_036	謎のスシライカー？
EnemyTitle_037	バンブーク精鋭第１小隊
EnemyTitle_038	バンブーク精鋭第１小隊
EnemyTitle_039	バンブーク精鋭第１小隊
EnemyTitle_040	バンブーク精鋭第１小隊
EnemyTitle_041	帰ってきたライバル？
EnemyTitle_042	戦闘第４０３小隊
EnemyTitle_043	戦闘第４０３小隊
EnemyTitle_044	戦闘第４０３小隊
EnemyTitle_045	戦闘第４０３小隊
EnemyTitle_046	謎のスシライカー？
EnemyTitle_047	バンブーク精鋭第２小隊
EnemyTitle_048	バンブーク精鋭第２小隊
EnemyTitle_049	バンブーク精鋭第２小隊
EnemyTitle_050	バンブーク精鋭第２小隊
EnemyTitle_051	帰ってきたライバル？？
EnemyTitle_052	ワサビひとすじ六十年
EnemyTitle_053	戦闘第５０４小隊
EnemyTitle_054	戦闘第５０４小隊
EnemyTitle_055	戦闘第５０４小隊
EnemyTitle_056	戦闘第５０４小隊
EnemyTitle_057	超謎のスシライカー？
EnemyTitle_058	グロム精鋭第１小隊
EnemyTitle_059	グロム精鋭第１小隊
EnemyTitle_060	グロム精鋭第１小隊
EnemyTitle_061	グロム精鋭第１小隊
EnemyTitle_062	超ひみつ兵器
EnemyTitle_063	戦闘第５０５小隊
EnemyTitle_064	戦闘第５０５小隊
EnemyTitle_065	戦闘第５０５小隊
EnemyTitle_066	戦闘第５０５小隊
EnemyTitle_067	超ひみつ兵器
EnemyTitle_068	グロム精鋭第２小隊
EnemyTitle_069	グロム精鋭第２小隊
EnemyTitle_070	グロム精鋭第２小隊
EnemyTitle_071	グロム精鋭第２小隊
EnemyTitle_072	雷鳴のスシライカー
EnemyTitle_073	邪道食いマスター
EnemyTitle_074	戦闘第６０７小隊
EnemyTitle_075	戦闘第６０７小隊
EnemyTitle_076	戦闘第６０７小隊
EnemyTitle_077	戦闘第６０７小隊
EnemyTitle_078	深まる謎のスシライカー
EnemyTitle_079	ソスナ精鋭第１小隊
EnemyTitle_080	ソスナ精鋭第１小隊
EnemyTitle_081	ソスナ精鋭第１小隊
EnemyTitle_082	ソスナ精鋭第１小隊
EnemyTitle_083	再び帰ってきたライバル？
EnemyTitle_084	戦闘第６０８小隊
EnemyTitle_085	戦闘第６０８小隊
EnemyTitle_086	戦闘第６０８小隊
EnemyTitle_087	戦闘第６０８小隊
EnemyTitle_088	深まる謎のスシライカー
EnemyTitle_089	ソスナ精鋭第２小隊
EnemyTitle_090	ソスナ精鋭第２小隊
EnemyTitle_091	ソスナ精鋭第２小隊
EnemyTitle_092	ソスナ精鋭第２小隊
EnemyTitle_093	再び帰ってきたライバル？？
EnemyTitle_094	愛とスシのハンター
EnemyTitle_095	さいはて守備隊
EnemyTitle_096	さいはて守備隊
EnemyTitle_097	さいはて守備隊
EnemyTitle_098	さいはて守備隊
EnemyTitle_099	さいはて守備隊・新人
EnemyTitle_100	アブリコス精鋭第１小隊
EnemyTitle_101	アブリコス精鋭第１小隊
EnemyTitle_102	アブリコス精鋭第１小隊
EnemyTitle_103	アブリコス精鋭第１小隊
EnemyTitle_104	元司令官
EnemyTitle_105	あきらめない鉄の意志？
EnemyTitle_106	アブリコス精鋭第２小隊
EnemyTitle_107	アブリコス精鋭第２小隊
EnemyTitle_108	アブリコス精鋭第２小隊
EnemyTitle_109	アブリコス精鋭第２小隊
EnemyTitle_110	特別訓練棟警備隊
EnemyTitle_111	デンジャラススシライカー
EnemyTitle_112	戦闘第８０９小隊
EnemyTitle_113	戦闘第８０９小隊
EnemyTitle_114	戦闘第８０９小隊
EnemyTitle_115	戦闘第８０９小隊
EnemyTitle_116	深まる謎のスシライカー
EnemyTitle_117	グロム精鋭第３小隊
EnemyTitle_118	グロム精鋭第３小隊
EnemyTitle_119	グロム精鋭第３小隊
EnemyTitle_120	グロム精鋭第３小隊
EnemyTitle_121	超ひみつ兵器
EnemyTitle_122	戦闘第８１０小隊
EnemyTitle_123	戦闘第８１０小隊
EnemyTitle_124	戦闘第８１０小隊
EnemyTitle_125	戦闘第８１０小隊
EnemyTitle_126	グロム精鋭第４小隊
EnemyTitle_127	グロム精鋭第４小隊
EnemyTitle_128	グロム精鋭第４小隊
EnemyTitle_129	グロム精鋭第４小隊
EnemyTitle_130	超ひみつ兵器
EnemyTitle_131	雷鳴のスシライカー
EnemyTitle_132	皇帝親衛隊第１小隊
EnemyTitle_133	皇帝親衛隊第１小隊
EnemyTitle_134	皇帝親衛隊第１小隊
EnemyTitle_135	皇帝親衛隊第１小隊
EnemyTitle_136	深まる謎のスシライカー
EnemyTitle_137	皇帝親衛隊第２小隊
EnemyTitle_138	皇帝親衛隊第２小隊
EnemyTitle_139	皇帝親衛隊第２小隊
EnemyTitle_140	皇帝親衛隊第２小隊
EnemyTitle_141	皇帝親衛隊
EnemyTitle_142	皇帝親衛隊
EnemyTitle_143	皇帝親衛隊
EnemyTitle_144	皇帝親衛隊
EnemyTitle_145	すべてを食らいつくす者
EnemyTitle_146	終わらない悪夢のスシライカー
EnemyTitle_221	スシ補完計画実行部隊
EnemyTitle_222	スシ補完計画実行部隊
EnemyTitle_223	スシ補完計画実行部隊
EnemyTitle_224	スシ補完計画実行部隊
EnemyTitle_225	スシ補完計画実行部隊
EnemyTitle_226	スシ補完計画実行部隊
EnemyTitle_227	スシ補完計画実行部隊
EnemyTitle_228	スシ補完計画実行部隊
EnemyTitle_233	ソスナ精鋭第３小隊
EnemyTitle_234	ソスナ精鋭第３小隊
EnemyTitle_235	ソスナ精鋭第３小隊
EnemyTitle_236	ソスナ精鋭第３小隊
EnemyTitle_237	スシ補完計画実行部隊
EnemyTitle_238	スシ補完計画実行部隊
EnemyTitle_239	スシ補完計画実行部隊
EnemyTitle_240	スシ補完計画実行部隊
EnemyTitle_249	スシ補完計画実行部隊
EnemyTitle_250	スシ補完計画実行部隊
EnemyTitle_251	スシ補完計画実行部隊
EnemyTitle_252	スシ補完計画実行部隊
EnemyTitle_255	スシ補完計画実行部隊
EnemyTitle_256	スシ補完計画実行部隊
EnemyTitle_257	スシ補完計画実行部隊
EnemyTitle_258	スシ補完計画実行部隊
EnemyTitle_259	本土北方守備隊
EnemyTitle_260	本土北方守備隊
EnemyTitle_261	本土北方守備隊
EnemyTitle_262	本土北方守備隊
EnemyTitle_263	スシ補完計画実行部隊
EnemyTitle_264	忘れられた部隊
EnemyTitle_265	忘れられた部隊
EnemyTitle_266	忘れられた部隊
EnemyTitle_267	忘れられた部隊
EnemyTitle_268	求道のスシライカー
EnemyTitle_271	スシ補完計画実行部隊
EnemyTitle_197	戦闘第１０６小隊
EnemyTitle_198	戦闘第１０６小隊
EnemyTitle_199	戦闘第１０６小隊
EnemyTitle_200	戦闘第１０６小隊
EnemyTitle_201	特務隊兄弟戦士
EnemyTitle_202	特務隊兄弟戦士
EnemyTitle_203	特務隊第１小隊
EnemyTitle_204	特務隊第１小隊
EnemyTitle_205	特務隊第１小隊
EnemyTitle_206	特務隊第１小隊
EnemyTitle_253	スシ補完計画実行部隊
EnemyTitle_254	スシ補完計画実行部隊
EnemyTitle_209	本土南部守備隊
EnemyTitle_210	本土南部守備隊
EnemyTitle_211	本土南部守備隊
EnemyTitle_212	本土南部守備隊
EnemyTitle_213	特務隊第２小隊
EnemyTitle_214	特務隊第２小隊
EnemyTitle_215	特務隊第２小隊
EnemyTitle_216	特務隊第２小隊
EnemyTitle_217	超ひみつ兵器
EnemyTitle_218	特務隊研究所
EnemyTitle_269	スシ補完計画実行部隊
EnemyTitle_270	スシ補完計画実行部隊
EnemyTitle_219	特務隊ボス
EnemyTitle_272	スシ解放戦線総長
EnemyTitle_273	バンブーク親衛隊
EnemyTitle_274	シースーライカー
EnemyTitle_275	運命のライバル？
EnemyTitle_276	ソスナ親衛隊
EnemyTitle_277	ストロンゲストスシライカー
EnemyTitle_278	魅惑のスシライカー
EnemyTitle_279	スシの錬金術師
EnemyTitle_280	プリティーソルジャー
EnemyTitle_281	マッドネススシライカー
EnemyTitle_282	マッスル決死隊
EnemyTitle_283	暗黒のスシライカー
EnemyTitle_284	スパイシースシライカー
EnemyTitle_285	スシコマンドー部隊
EnemyTitle_286	超ひみつ兵器
EnemyTitle_287	スーパースシライカー
EnemyTitle_288	バンブーク親衛隊
EnemyTitle_289	邪道の落武者
EnemyTitle_290	ハートフルスシライカー
EnemyTitle_291	ソスナ親衛隊
EnemyTitle_292	永遠のライバル？
EnemyTitle_293	雷光のスシライカー
EnemyTitle_294	スシの錬金術師
EnemyTitle_295	ワサビひとすじ五十五年
EnemyTitle_296	ゴイスーシースーライカー
EnemyTitle_297	マッスル決死隊
EnemyTitle_298	ラブ&スシハンター
EnemyTitle_299	プリティーアサシン
EnemyTitle_300	スシコマンドー部隊
EnemyTitle_301	サイコスシライカー
EnemyTitle_302	スーパースシライカー
EnemyTitle_C_001	スシ補完計画実行部隊
EnemyTitle_C_002	スシ補完計画実行部隊
EnemyTitle_C_003	スシ補完計画実行部隊
EnemyTitle_C_004	スシ補完計画実行部隊
EnemyTitle_C_005	スシ補完計画特務隊
EnemyTitle_C_006	スシ補完計画実行部隊
EnemyTitle_C_007	スシ補完計画実行部隊
EnemyTitle_C_008	スシ補完計画実行部隊
EnemyTitle_C_009	スシ補完計画実行部隊
EnemyTitle_C_010	スシ補完計画特務隊
EnemyTitle_C_011	スシ補完計画実行部隊
EnemyTitle_C_012	スシ補完計画実行部隊
EnemyTitle_C_013	スシ補完計画実行部隊
EnemyTitle_C_014	スシ補完計画実行部隊
EnemyTitle_C_015	スシ補完計画特務隊
EnemyTitle_C_016	スシ補完計画実行部隊
EnemyTitle_C_017	スシ補完計画実行部隊
EnemyTitle_C_018	スシ補完計画実行部隊
EnemyTitle_C_019	スシ補完計画実行部隊
EnemyTitle_C_020	スシ補完計画特務隊
EnemyTitle_C_021	スシ補完計画特務隊
EnemyTitle_C_022	スシ補完計画特務隊
EnemyTitle_C_023	スシ補完計画特務隊
EnemyTitle_C_024	スシ補完計画特務隊
EnemyTitle_C_025	超ひみつ兵器
EnemyTitle_VS	スシライカーランク
Enemy_Tutorial02_Advice	くっ…ま…{r[ま]}負{/r}けたの…！？\nく…くやしい……
PlayerAdvice000	{r[さら]}皿{/r}は{r[みじか]}短{/r}く{r[なんど]}何度{/r}もつなげるより\nとにかく{r[なが]}長{/r}くつなげるべしじゃ
PlayerAdvice001	レーンドライブを{r[つか]}使{/r}いジグザグに\n{r[さら]}皿{/r}をつなげていくのが{r[きほん]}基本{/r}じゃ
PlayerAdvice002	７{r[さらいじょう]}皿以上{/r}つなげると、どの{r[いろ]}色{/r}の{r[さら]}皿{/r}\nとしても{r[つか]}使{/r}える{r[にじざら]}虹皿{/r}が{r[で]}出{/r}るぞ
PlayerAdvice003	{r[さら]}皿{/r}に{r[の]}乗{/r}って{r[なが]}流{/r}れてくるフルーツを\n{r[た]}食{/r}べるとHPが{r[すこ]}少{/r}し{r[かいふく]}回復{/r}するのじゃ
PlayerAdvice004	スシ{r[まつ]}祭{/r}り{r[ちゅう]}中{/r}は{r[こうげきりょく]}攻撃力{/r}が1.5{r[ばい]}倍{/r}に\nなる。{r[こうげき]}攻撃{/r}のチャンスじゃぞ
PlayerAdvice005	たくさんの{r[さら]}皿{/r}をつなげるほど、\n{r[まつり]}祭{/r}ゲージの{r[あ]}上{/r}がり{r[かた]}方{/r}も{r[おお]}大{/r}きいぞ
PlayerAdvice006	{r[にじざら]}虹皿{/r}をふくんだつみ{r[ざら]}皿{/r}ならば、\n{r[てき]}敵{/r}の{r[こうげき]}攻撃{/r}でもくずれぬのじゃ
PlayerAdvice007	{r[さら]}皿{/r}をつなげられる{r[じかん]}時間{/r}は7{r[びょう]}秒{/r}ある\n10{r[さら]}皿{/r}20{r[さら]}皿{/r}とつなげるのじゃ
PlayerAdvice008	{r[さら]}皿{/r}が{r[とお]}通{/r}るすき{r[ま]}間{/r}さえあれば、{r[とお]}遠{/r}く\nのレーンとも{r[さら]}皿{/r}はつなげられるぞ
PlayerAdvice009	{r[とら]}虎{/r}の{r[まき]}巻{/r}の「バトルの{r[ごくい]}極意{/r}」には\n{r[か]}  K0勝{/r}\u000f\u0001\u0000つためのヒントが{r[まんさい]}満載{/r}じゃぞ
PlayerAdvice010	{r[しょうぶ]}勝負{/r}は{r[とき]}時{/r}の{r[うん]}運{/r}。{r[つぎ]}次{/r}は{r[か]}勝{/r}てるやも\n{r[し]}知{/r}れぬ…あきらめてはいかんぞ。
PlayerAdvice011	「スキルのおふだ」をスシガミに\n{r[つか]}使{/r}えばスキルLvを{r[あ]}上{/r}げられるぞ
PlayerAdvice012	{r[か]}  K0勝{/r}\u000f\u0001\u0000てぬ{r[とき]}時{/r}はスキルの{r[く]}組{/r}み{r[あ]}合{/r}わせを\n{r[かんが]}考{/r}えてみるのも{r[て]}手{/r}じゃぞ
PlayerAdvice013	{r[か]}  K0勝{/r}\u000f\u0001\u0000てぬ{r[とき]}時{/r}はスキルとスシパワーの\n{r[あいしょう]}相性{/r}を{r[かんが]}考{/r}えるのも{r[て]}手{/r}じゃな
PlayerSpecialAdvice	ここは…「ふっかつのまめ」を\n{r[つか]}使{/r}うのもいいかも{r[し]}知{/r}れぬな…
Player_StgAdvice001	{r[さら]}皿{/r}は{r[みじか]}短{/r}く{r[なんど]}何度{/r}もつなげるより\nとにかく{r[なが]}長{/r}くつなげるべしじゃ
Player_StgAdvice002	{r[さら]}皿{/r}が{r[とお]}通{/r}るすき{r[ま]}間{/r}さえあれば、{r[とお]}遠{/r}く\nのレーンとも{r[さら]}皿{/r}はつなげられるぞ
Player_StgAdvice003	レーンドライブを{r[つか]}使{/r}いジグザグに\n{r[さら]}皿{/r}をつなげていくのが{r[きほん]}基本{/r}じゃ
Player_StgAdvice013	{c[ffae00]}{r[はちさら]}八皿{/r}ウォールは{r[りょうしゃ]}両者{/r}に{r[こうか]}効果{/r}がある\n…コジローも{r[くる]}苦{/r}しいはずじゃ。{c[000000]}
Player_StgAdvice018	{c[ffae00]}なかなかうまくつながらない{r[とき]}時{/r}は\n{r[ひゃくれんざら]}百連皿{/r}を{r[かつよう]}活用{/r}するとよいぞ！{c[000000]}
Player_StgAdvice057	{c[ffae00]}このアイテムの{r[いろ]}色{/r}は{r[いっていじかん]}一定時間{/r}で\n{r[か]}変{/r}わる…{r[あか]}赤{/r}を{r[と]}取{/r}ってはいかんぞ！{c[000000]}
Player_StgAdvice064	{c[ffae00]}このアイテムの{r[いろ]}色{/r}は{r[いっていじかん]}一定時間{/r}で\n{r[か]}変{/r}わる…{r[あか]}赤{/r}を{r[と]}取{/r}ってはいかんぞ！{c[000000]}
Player_StgAdvice067	{c[ffae00]}{r[かべ]}壁{/r}が{r[うご]}動{/r}いている{r[あいだ]}間{/r}は{r[こうげき]}攻撃{/r}がきかぬ\n{r[と]}止{/r}まったときをねらうのじゃ…!!{c[000000]}
Player_StgAdvice083	{c[ffae00]}{r[こんかい]}今回{/r}は{r[なが]}長{/r}くつなげなくていい…\n{r[おな]}同{/r}じ{r[いろ]}色{/r}の{r[さら]}皿{/r}を{r[つづ]}続{/r}けて{r[た]}食{/r}べるのじゃ{c[000000]}
Player_StgAdvice088	{c[ffae00]}コンボウォールも{r[りょうしゃ]}両者{/r}への{r[こうか]}効果{/r}…\nコジローも{r[くる]}苦{/r}しいはずじゃ…{c[000000]}
Player_StgAdviceSosuna	{c[ffae00]}{r[あか]}赤{/r}いスシとはサーモンとマグロ…\nヒカリノコロモの{r[こうか]}効果{/r}は{r[いちじてき]}一時的{/r}…{c[000000]}
Player_StgWin_001	これがスシバトル…\nスシをたくさん{r[た]}食{/r}べられたぜ♪
Player_StgWin_002	またまた{r[か]}勝{/r}っちまったぜ！\nスシをたくさん{r[た]}食{/r}べられて{r[しあわ]}幸{/r}せ～♪
Player_StgWin_003	どうだコジロー！\nレーンドライブギアのチカラは！！
Player_StgWin_004	へへ～ん♪\nスイーツならオレだって{r[だいこうぶつ]}大好物{/r}だぜ！
Player_StgWin_005	{r[でんげき]}電撃{/r}シュート？\nぜんぜんシビれなかったなあ！
Player_StgWin_006	へっ！\nシールドなんて{r[かんけい]}関係{/r}ねえぜ！！
Player_StgWin_007	ひゅう♪\nすごいスピードバトルだったぜ！
Player_StgWin_008	どうだ！\n{r[こども]}子供{/r}あつかいはやめてもらうぜ！
Player_StgWin_009	あんたの{r[とつげき]}突撃{/r}\n{r[みき]}見切{/r}っちゃったもんね♪
Player_StgWin_010	カプセルか たしかに{r[べんり]}便利{/r}だな！\nいいものを{r[おし]}教{/r}えてもらったぜ♪
Player_StgWin_011	{r[とくしゅとくしゅ]}特殊特殊{/r}って{r[い]}言{/r}ってばっかで\nバトルがおろそかだったぜ？
Player_StgWin_012	{r[おれ]}俺{/r}の{r[か]}勝{/r}ちだ！\n{r[さき]}先{/r}に{r[すす]}進{/r}ませてもらうぜ♪
Player_StgWin_013	{r[おれ]}俺{/r}は{r[ていこく]}帝国{/r}には{r[はい]}入{/r}らないからな！\n{r[おぼ]}覚{/r}えておけコジロー！！
Player_StgWin_014	{r[ふく]}服{/r}はちゃんと{r[き]}着{/r}たほうがいいぜ？
Player_StgWin_015	{r[こども]}子供{/r}あつかいするんじゃねえ！\nたしかに… {r[きんにく]}筋肉{/r}はねえけどよ……
Player_StgWin_016	スシライカーにマッチョは\n{r[かんけい]}関係{/r}ある…のか？
Player_StgWin_017	{r[たいちょう]}隊長{/r}だろうとマッチョだろうと\n{r[た]}立{/r}ちはだかる{r[いじょう]}以上{/r}は{r[かんけい]}関係{/r}ねえ！
Player_StgWin_018	これで{r[ぶたい]}部隊{/r}はクビだな！\nいっそ{r[ていこく]}帝国{/r}からもぬけちまえよ？
Player_StgWin_019	スシが{r[い]}入{/r}れかわっても\n{r[た]}食{/r}べることには{r[か]}変{/r}わりねえぜ！
Player_StgWin_020	{r[おれ]}俺{/r}と{r[おな]}同{/r}じくらいの\nおんなのこ…!?
Player_StgWin_021	あの{r[こ]}子{/r}のことが{r[き]}気{/r}になるな…\nここは{r[とお]}通{/r}してもらうぜ！
Player_StgWin_022	{r[か]}勝{/r}ったんだから{r[とお]}通{/r}してもらうぜ！\nさあ どいたどいた!!
Player_StgWin_023	ユーリアが{r[い]}行{/r}ったのは\nこっちで{r[あ]}合{/r}っているのか？
Player_StgWin_024	この{r[さき]}先{/r}にユーリアがいるのか…？
Player_StgWin_025	ユーリア… すこしは{r[はなし]}話{/r}を\n{r[き]}聞{/r}いてくれる{r[き]}気{/r}になったか？
Player_StgWin_026	{r[きんにく]}筋肉{/r}がしぼむわけねえだろ！\nいいから{r[はや]}早{/r}くそこをどいてくれ！！
Player_StgWin_027	ム、ムテキンニク？\n{r[きんにく]}筋肉{/r}にもいろいろあるんだな…
Player_StgWin_028	お、おい… {r[ま]}負{/r}けたのに\n{r[いっく]}一句{/r}{r[よ]}詠{/r}んでんじゃねえよ……
Player_StgWin_029	{r[きんにく]}筋肉{/r}はえんりょしておくぜ\nオレはスシライカーだからな！
Player_StgWin_030	バカじゃねえ！ ユーリアとは\n{r[なかま]}仲間{/r}になれる{r[き]}気{/r}がするんだ！！
Player_StgWin_031	バキューム{r[ぐ]}食{/r}いなんかじゃ\nスシの{r[あじ]}味{/r}が{r[わ]}分{/r}からないだろ！！
Player_StgWin_032	{r[かぜ]}風邪{/r}でもひいているのか？\nそういうときは{r[むり]}無理{/r}するなよ？
Player_StgWin_033	{r[じぜん]}事前{/r}に{r[めぐすり]}目薬{/r}でもさしておけよな！\nバトルには{r[しゅうちゅう]}集中{/r}しないとだぜ♪
Player_StgWin_034	{r[あじ]}味{/r}が{r[わ]}分{/r}からないなんて\nスシの{r[たの]}楽{/r}しさが{r[はんげん]}半減{/r}しちゃうな…
Player_StgWin_035	おいおい、この{r[ぶたい]}部隊{/r}のやつら\n{r[ぜんいん]}全員{/r}が{r[たいちょうふりょう]}体調不良{/r}じゃねえか……
Player_StgWin_036	あんたにも{r[な]}慣{/r}れてきたぜ♪\nシースーマイウ～♪♪
Player_StgWin_037	あのじいちゃんにゾッコン…\nなのか……？
Player_StgWin_038	え、えっと… ごめんよ？\n{r[な]}泣{/r}かせるつもりは……
Player_StgWin_039	わ、わりい…\nこの{r[ぶたい]}部隊{/r}、やりづらいぞ……
Player_StgWin_040	あ、あの… よかったら\nオレも{r[いっしょ]}一緒{/r}に{r[おこ]}怒{/r}られようか…？
Player_StgWin_041	どうって…\nふつうに{r[よ]}避{/r}けただけだぜ？
Player_StgWin_042	ワサビが{r[く]}食{/r}えないからって\n{r[こども]}子供{/r}あつかいするんじゃねえ!!
Player_StgWin_043	ワサビは{r[にがて]}苦手{/r}だけども、スシとの\n{r[あいしょう]}相性{/r}は{r[わる]}悪{/r}くねえ{r[き]}気{/r}がするんだよな…
Player_StgWin_044	これはワサビ{r[ず]}好{/r}きじゃなくて\nもはやワサビ{r[ちゅうどく]}中毒{/r}だな……
Player_StgWin_045	ワサビが{r[す]}好{/r}きすぎて、もうなにを\n{r[い]}言{/r}っているのかわからねえ……
Player_StgWin_046	ちょり～っす♪\nいいバトルだったぜ♪♪
Player_StgWin_047	{r[わる]}悪{/r}いな、ねえちゃん\n{r[さき]}先{/r}に{r[すす]}進{/r}まないといけないんだ！
Player_StgWin_048	オレでよければ、ねえちゃんと\nかくれんぼしても… いいぜ？
Player_StgWin_049	ナデナデならオレが\nしてあげないことも… ないぜ？
Player_StgWin_050	ム、ムサシちゃん？\nなんだか{r[ちょうし]}調子{/r}がくるうぜ……
Player_StgWin_051	{r[しゅっせ]}出世{/r}ばかり{r[き]}気{/r}にしてても\n{r[しゅっせ]}出世{/r}はできないと{r[おも]}思{/r}うぜ？
Player_StgWin_052	ワサビが{r[た]}食{/r}べられるようになれば\n{r[こども]}子供{/r}あつかいされなくなるかな？
Player_StgWin_053	グロム… ウワサに{r[き]}聞{/r}く\n{r[ていこくいち]}帝国一{/r}のスシライカー……
Player_StgWin_054	{r[す]}好{/r}き{r[きら]}嫌{/r}いは{r[よ]}良{/r}くねえぜ？
Player_StgWin_055	{r[こども]}子供{/r}あつかい{r[きんし]}禁止{/r}って{r[ちゅういが]}注意書{/r}きも\n{r[た]}足{/r}すように{r[つた]}伝{/r}えておいてな！
Player_StgWin_056	わざわざ{r[ちゅうい]}注意{/r}してくれて\nサンキューな♪
Player_StgWin_057	え、えっと… オレはヨイツーな\nシースーのライカーだぜ…… かな？
Player_StgWin_058	{r[だれ]}誰{/r}が{r[あいて]}相手{/r}だろうと、ここで{r[あし]}足{/r}を\n{r[と]}止{/r}めるわけにはいかないんだ！
Player_StgWin_059	エリートだろうとなんだろうと\nスシはみんなに{r[びょうどう]}平等{/r}なんだぜ♪
Player_StgWin_060	でもグロム{r[たい]}隊{/r}はエリートなんだから\n{r[か]}勝{/r}てたならいい{r[き]}気{/r}になっちゃうぜ？
Player_StgWin_061	エリートエリートって\nもう{r[き]}聞{/r}き{r[あ]}飽{/r}きちまったぜ…
Player_StgWin_062	ちょっとビビったけど、{r[おお]}大{/r}きけりゃ\nいいってもんでもねえぜ!!
Player_StgWin_063	へへ～ん♪ グロムのいどころまで\nノンストップでつきすすむぜ！
Player_StgWin_064	{r[あっしゅくじんけい]}圧縮陣形{/r}？ {r[てき]}敵{/r}さんの{r[はいち]}配置{/r}が\nやたら{r[ちか]}近{/r}いのはそのせいか…
Player_StgWin_065	スシは{r[ひと]}人{/r}を{r[えがお]}笑顔{/r}にするものだ♪\n{r[たの]}楽{/r}しんで{r[た]}食{/r}べないとだぜ♪♪
Player_StgWin_066	あのデッケー{r[たいほう]}大砲{/r}のことか？\nそれならもうなれっこだぜ♪
Player_StgWin_067	{r[みち]}道{/r}をあけてもらうぜ！\nグロムを{r[お]}追{/r}いかけねえと…！
Player_StgWin_068	パーティが{r[ひら]}開{/r}けなくなって\n{r[わる]}悪{/r}いことしちまったか？
Player_StgWin_069	{r[い]}言{/r}い{r[わけ]}訳{/r}するなんて\n{r[おとこ]}男{/r}らしくねえぞ！
Player_StgWin_070	お{r[まえ]}前{/r}がスシを{r[す]}好{/r}きなことは\n{r[たたか]}戦{/r}っていて{r[つた]}伝{/r}わってきたぜ♪
Player_StgWin_071	まだいるかもしれねえ！\n{r[さき]}先{/r}に{r[い]}行{/r}かせてもらうぜ!!
Player_StgWin_072	{r[うれ]}嬉{/r}しい{r[ごさん]}誤算{/r}だって!?\n{r[いったい]}一体{/r}なにを{r[い]}言{/r}ってやがる!!
Player_StgWin_073	スシは{r[ごうりせい]}合理性{/r}どうこうじゃねえ！\nおいしく{r[ぜんぶ]}全部{/r}を{r[た]}食{/r}べるものだ!!
Player_StgWin_074	{r[わる]}悪{/r}いな、おっちゃん\n{r[さき]}先{/r}に{r[い]}行{/r}かせてもらうぜ！
Player_StgWin_075	おう！ オレがムサシだ！\nもしかしてちょっと{r[ゆうめいじん]}有名人{/r}？
Player_StgWin_076	トドメなんてささねえよ\nそれじゃまるで{r[あくやく]}悪役{/r}だぜ
Player_StgWin_077	ん？ {r[か]}勝{/r}っても{r[あじ]}味{/r}なんてしねえけど\n{r[ま]}負{/r}けると{r[あじ]}味{/r}がするのか??
Player_StgWin_078	シースー？ ムーゲー??\n{r[いったい]}一体{/r}なんなんだ…??
Player_StgWin_079	なんだこいつ？\n{r[しか]}叱{/r}られるのに{r[よろこ]}喜{/r}んでるぞ？？
Player_StgWin_080	こ、こいつもおかしいぞ…。\n{r[しか]}叱{/r}ってくれってお{r[ねが]}願{/r}いするなんて…
Player_StgWin_081	……。\nあのオバサンの{r[ぶか]}部下{/r}、{r[だいじょうぶ]}大丈夫{/r}か…
Player_StgWin_082	た、{r[たいちょう]}隊長{/r}が{r[いちばん]}一番{/r}{r[しんぱい]}心配{/r}なやつだった…
Player_StgWin_083	たしかにちょっと{r[くせん]}苦戦{/r}したけど…\nオレは{r[ま]}負{/r}けられねえんだ!!
Player_StgWin_084	ソスナって{r[ひと]}人{/r}の{r[ぶか]}部下{/r}たちは\n{r[あか]}赤{/r}いスシを{r[た]}食{/r}べると{r[おこ]}怒{/r}られるのか…
Player_StgWin_085	{r[あか]}赤{/r}いスシが{r[つよ]}強{/r}いんじゃねえ！\nバランスよく{r[た]}食{/r}べるから{r[つよ]}強{/r}いんだ！
Player_StgWin_086	{r[いじ]}意地{/r}はってないで\n{r[あか]}赤{/r}いスシも{r[た]}食{/r}べちゃえよ？
Player_StgWin_087	{r[むり]}無理{/r}に{r[あか]}赤{/r}いスシをガマンするから\nスシの{r[まぼろし]}幻{/r}が{r[み]}見{/r}えちゃってるんだな…
Player_StgWin_088	シースーがマイウーでガトアリ…\nうう… {r[こんらん]}混乱{/r}してくるぜ……
Player_StgWin_089	{r[ぶか]}部下{/r}がスシバトルをしているときに\n{r[じぶん]}自分{/r}は{r[ゆうが]}優雅{/r}にスイーツなんだな…
Player_StgWin_090	{r[はや]}早{/r}く{r[い]}行{/r}きたかったからバトル{r[ちゅう]}中{/r}\nずっとソワソワしていたのか？
Player_StgWin_091	そっか…\nあんたたちも{r[くろう]}苦労{/r}してんだな……
Player_StgWin_092	ん？\nソスナがなんだって？
Player_StgWin_093	い、いや、うらみはねえけど\n{r[しょうぶ]}勝負{/r}を{r[いど]}挑{/r}んでくるから……
Player_StgWin_094	へへ～ん♪ {r[あか]}赤{/r}いスシ{r[いがい]}以外{/r}の\nスシだってあるんだもんね♪♪
Player_StgWin_095	ぶえっくし…！\nた、たしかに{r[さむ]}寒{/r}いな……
Player_StgWin_096	お、おう…！ いさぎよいな！\nしっかり{r[あたた]}暖{/r}まってくれよな!!
Player_StgWin_097	こっちだって{r[さむ]}寒{/r}いんだ！\nなんなんだここは!!
Player_StgWin_098	うまいこと{r[い]}言{/r}った……のか？
Player_StgWin_099	あーー！ そのセリフは!!\nおっちゃんのこと{r[おも]}思{/r}い{r[だ]}出{/r}したぜ!!
Player_StgWin_100	あ！ {r[おも]}思{/r}い{r[だ]}出{/r}した！ {r[ふく]}服{/r}はちゃんと{r[き]}着{/r}ろ\nってアドバイスしたじゃんか!!
Player_StgWin_101	おう！ バトルをたくさんして\n{r[きんにく]}筋肉{/r}だってちょっぴり{r[つ]}付{/r}いたぜ!!
Player_StgWin_102	マッチョのこだわりはどうしても\n{r[す]}捨{/r}てられない{r[ひと]}人{/r}たちなんだな……
Player_StgWin_103	オ、オレが{r[しん]}真{/r}のマッチョ…？\nそれって… {r[よろこ]}喜{/r}んでいい……のか??
Player_StgWin_104	えー、だって{r[ほんとう]}本当{/r}のことを\n{r[い]}言{/r}ったまでじゃんか～
Player_StgWin_105	{r[め]}目{/r}を{r[さ]}覚{/r}ませ！ あんなやり{r[かた]}方{/r}で\n{r[つよ]}強{/r}くなれるわけがないだろうッ!!
Player_StgWin_106	あ！ {r[きんにく]}筋肉{/r}しぼむ{r[ひと]}人{/r}!!\nにいちゃんは{r[じゅうぶん]}十分{/r}マッチョだぜ!!
Player_StgWin_107	おお！ {r[こんど]}今度{/r}はムテキンニクの{r[ひと]}人{/r}!!\nアブリコス{r[たい]}隊{/r}が{r[せい]}勢{/r}ぞろいなのか!?
Player_StgWin_108	{r[きんにく]}筋肉{/r}{r[はいく]}俳句{/r}の{r[ひと]}人{/r}も{r[おぼ]}覚{/r}えてるぞ！\nなんだか{r[しんり]}真理{/r}にたどり{r[つ]}着{/r}いた…？
Player_StgWin_109	マッチョも{r[たの]}楽{/r}しそうに{r[おも]}思{/r}えてきて\nちょっと{r[かんが]}考{/r}えちゃうなあ…
Player_StgWin_110	ユキチさんを{r[たす]}助{/r}けたいんだ！\n{r[とお]}通{/r}してもらうぜ！！
Player_StgWin_111	もうやめろアブリコス！\nそんな{r[た]}食{/r}べ{r[かた]}方{/r}はスシに{r[しつれい]}失礼{/r}だぞ!!
Player_StgWin_112	そ、そうなのか？\nあんまり{r[き]}気{/r}に{r[や]}病{/r}むなよ…？
Player_StgWin_113	あれ？ さっきも{r[じぶん]}自分{/r}のことを\n{r[さいじゃく]}最弱{/r}って{r[い]}言{/r}う{r[ひと]}人{/r}がいたような…？
Player_StgWin_114	この{r[ぶたい]}部隊{/r}の{r[ひと]}人{/r}たち\nみんな{r[い]}言{/r}い{r[わけ]}訳{/r}が{r[おな]}同{/r}じだぞ…
Player_StgWin_115	おっちゃんが{r[いちばん]}一番{/r}{r[よわ]}弱{/r}いのか…？\nいったい{r[だれ]}誰{/r}が{r[ほんとう]}本当{/r}の{r[さいじゃく]}最弱{/r}なんだ……
Player_StgWin_116	オレもあんたとバトルをするのが\n{r[あ]}当{/r}たり{r[まえ]}前{/r}に{r[おも]}思{/r}えてきたぜ♪
Player_StgWin_117	ルツコイさんか…\nどんなスシバトルか{r[たの]}楽{/r}しみだぜ♪
Player_StgWin_118	{r[こんど]}今度{/r}はマツイさんか…\n{r[つぎ]}次{/r}の{r[ひと]}人{/r}に{r[たく]}託{/r}す{r[かん]}感{/r}じなのか…？
Player_StgWin_119	この{r[ぶたい]}部隊{/r}の{r[へいたい]}兵隊{/r}さんたちは\nなんだかみんな{r[ひとまか]}人任{/r}せのような…
Player_StgWin_120	{r[たいちょう]}隊長{/r}さんはみんなの{r[せきにん]}責任{/r}が\nのしかかって{r[たいへん]}大変{/r}そうだな…
Player_StgWin_121	{r[ひみつへいき]}秘密兵器{/r}なんだっけ？\n{r[わる]}悪{/r}いな、{r[こわ]}壊{/r}しちまって！
Player_StgWin_122	マッチョはマッチョで{r[たいへん]}大変{/r}そうだし\nやめといたほうがいい{r[き]}気{/r}が…
Player_StgWin_123	ワ、ワサビは{r[かんべん]}勘弁{/r}してくれ～！\nあれはツーンとして{r[にがて]}苦手{/r}なんだ…
Player_StgWin_124	{r[むり]}無理{/r}にガマンするのは{r[よ]}良{/r}くねえぜ？\n{r[た]}食{/r}べたいスシを{r[た]}食{/r}べないとな！
Player_StgWin_125	エレガントさを{r[もと]}求{/r}める{r[まえ]}前{/r}に\nまずはスシを{r[しん]}信{/r}じるところからだな
Player_StgWin_126	スシ{r[すじ]}筋{/r}…？ スシのあつかいかたを\n{r[さ]}指{/r}す{r[ことば]}言葉{/r}か？ ……カッコイイな！
Player_StgWin_127	スシを{r[あい]}愛{/r}しているんだな…\nとうちゃん、いい{r[ぶか]}部下{/r}じゃんか……
Player_StgWin_128	ああ、これがオレのスシバトル！\nスシへの{r[かんしゃ]}感謝{/r}なら{r[だれ]}誰{/r}にも{r[ま]}負{/r}けねえ！
Player_StgWin_129	とうちゃんに{r[あ]}会{/r}って{r[はなし]}話{/r}をするんだ！\n{r[た]}立{/r}ち{r[ど]}止{/r}まるわけにはいかねえ!!
Player_StgWin_130	{r[へいたい]}兵隊{/r}だろうが{r[たいほう]}大砲{/r}だろうが\n{r[た]}立{/r}ちはだかるなら{r[う]}打{/r}ち{r[か]}勝{/r}つまでだ！
Player_StgWin_131	どうだとうちゃん！\nこれがオレのスシだッ!!
Player_StgWin_132	な、なんだ？ お{r[めん]}面{/r}かそれ？\nちょっと{r[こわ]}怖{/r}いぞ……
Player_StgWin_133	{r[い]}行{/r}き{r[ど]}止{/r}まりのワケないよな！\nウソだってバレバレだぜ!!
Player_StgWin_134	ずっと{r[おな]}同{/r}じコトを{r[い]}言{/r}っている…\nさ、{r[さき]}先{/r}に{r[い]}行{/r}かせてもらいま～す……
Player_StgWin_135	ひ、ひえっ…\nこの{r[ぶたい]}部隊{/r}、なんだかやばいぞ……
Player_StgWin_136	こんなところにも{r[あらわ]}現{/r}れるなんて\n{r[ほんとう]}本当{/r}になにものなんだ……
Player_StgWin_137	また{r[こども]}子供{/r}あつかい！ やめてくれよな\nとうちゃんの{r[まえ]}前{/r}なんだからよ…
Player_StgWin_138	{r[せいちょう]}成長{/r}したオレの{r[すがた]}姿{/r}をとうちゃんに\n{r[み]}見{/r}せたくてがんばってるんだ！
Player_StgWin_139	そんな{r[けいかく]}計画{/r}、オレととうちゃんで\nぶっ{r[こわ]}壊{/r}してやるぜ!!
Player_StgWin_140	グラードはこの{r[さき]}先{/r}か!?\n{r[い]}行{/r}こう、とうちゃん!!
Player_StgWin_141	お{r[まえ]}前{/r}たちがやろうとしている\nスシの{r[しはい]}支配{/r}なんて{r[みと]}認{/r}めねえぞ！
Player_StgWin_142	{r[はや]}早{/r}くとうちゃんを{r[お]}追{/r}いかけねえと！\n{r[わる]}悪{/r}いけど{r[さき]}先{/r}に{r[い]}行{/r}かせてもらうぜ！
Player_StgWin_143	{r[ていこく]}帝国{/r}のやり{r[かた]}方{/r}じゃ、{r[わら]}笑{/r}ってみんなで\nスシを{r[た]}食{/r}べられねえんだ！
Player_StgWin_144	グラードに{r[あ]}会{/r}わせてもらうぜ\nスシの{r[みらい]}未来{/r}を{r[はな]}話{/r}し{r[あ]}合{/r}いにきたんだ！
Player_StgWin_145	スシは{r[だれ]}誰{/r}かのものじゃねえ！\nみんなのものだ!!
Player_StgWin_146	みんなで{r[わら]}笑{/r}っておいしく{r[た]}食{/r}べる！\nそれがオレの{r[かんが]}考{/r}えるスシだ!!
Player_StgWin_197	この{r[いし]}石{/r}は{r[わた]}渡{/r}せねえ！\n{r[ほ]}欲{/r}しけりゃ{r[じぶん]}自分{/r}で{r[さが]}探{/r}すんだな♪
Player_StgWin_198	おっちゃん… {r[ま]}負{/r}けたのに\nダジャレを{r[い]}言{/r}っている{r[ばあい]}場合{/r}か？
Player_StgWin_199	{r[じんじゃ]}神社{/r}… そこにレーンドライブギアを\n{r[つく]}作{/r}る{r[ぎし]}技師{/r}がいるのか？
Player_StgWin_200	へへ～ん♪ こっちには{r[ゆうしゅう]}優秀{/r}な\n{r[じょうほうつう]}情報通{/r}がついているんだぜ♪
Player_StgWin_201	マ、マッチョじゃねえし！\nスシライカーのムサシだ！！
Player_StgWin_202	マッチョ～ マッチョ～…\nってなにやらせるんだ…！！
Player_StgWin_203	そのおっちゃんよりオレのほうが\n{r[いちまいうわて]}一枚上手{/r}だったってことだな♪
Player_StgWin_204	ん？ そのセリフ…\nさっきも{r[き]}聞{/r}いたような……
Player_StgWin_205	ここの{r[たいちょう]}隊長{/r}さんは、みんなのことを\n{r[さいきょう]}最強{/r}だって{r[い]}言{/r}っているのか…？
Player_StgWin_206	そういう{r[ほうしん]}方針{/r}だったのか…\nギアは{r[ぜったい]}絶対{/r}に{r[と]}取{/r}り{r[かえ]}返{/r}してやる…！
Player_StgWin_209	{r[だれ]}誰{/r}が{r[た]}立{/r}ちはだかろうと\nスシを{r[しん]}信{/r}じてバトルするだけだ！
Player_StgWin_210	あやしい{r[じっけん]}実験{/r}をしてるって{r[き]}聞{/r}いたぜ\nそれが{r[ほんとう]}本当{/r}ならオレが{r[と]}止{/r}める!!
Player_StgWin_211	その{r[とお]}通{/r}り♪\n{r[ぬす]}盗{/r}んだものを{r[かえ]}返{/r}してもらうぜ！
Player_StgWin_212	その{r[はつめい]}発明{/r}のためだったら{r[ひと]}人{/r}のものを\n{r[ぬす]}盗{/r}んでいいってわけじゃないぞ！
Player_StgWin_213	{r[さいじゃく]}最弱{/r}かどうかは{r[わ]}分{/r}からねえけど\n{r[だいじ]}大事{/r}なのはスシを{r[しん]}信{/r}じる{r[こころ]}心{/r}だ！
Player_StgWin_214	あ、あれ？\nこの{r[なが]}流{/r}れ… {r[まえ]}前{/r}にもあったような…
Player_StgWin_215	もしかしてこの{r[たい]}隊{/r}は\nたたいて{r[の]}伸{/r}ばす{r[ほうしん]}方針{/r}なんじゃ…？
Player_StgWin_216	なんだかおっちゃんさみしそうだ…\n{r[ぶか]}部下{/r}の{r[いくせい]}育成{/r}も{r[たいへん]}大変{/r}なんだな……
Player_StgWin_217	その{r[しせつ]}施設{/r}に{r[い]}行{/r}くために{r[き]}来{/r}たんだ！\n{r[でんじほう]}電磁砲{/r}まであるなんてあやしいぜ！
Player_StgWin_218	スシを{r[そまつ]}粗末{/r}にする{r[じっけん]}実験{/r}の{r[しせつ]}施設{/r}なんて\n{r[みと]}認{/r}めるわけにはいかねえ!!
Player_StgWin_219	{r[じんこう]}人工{/r}スシゲートなんかで\n{r[ほんとう]}本当{/r}の{r[しあわ]}幸{/r}せがやってくるはずない！
Player_StgWin_221	おっちゃんは{r[じぶん]}自分{/r}の{r[くち]}口{/r}のかたさを\n{r[うたが]}疑{/r}ったほうがいいかもだぜ…？
Player_StgWin_222	{r[い]}行{/r}くなと{r[い]}言{/r}われると\n{r[い]}行{/r}きたくなっちゃうよなあ♪
Player_StgWin_223	じゃあ{r[わる]}悪{/r}いけど\nしかられてくれよな♪
Player_StgWin_224	レアスシガミのゴクオウ\nオレがもらい{r[う]}受{/r}けるぜ！
Player_StgWin_225	ご、ごめんよ、ねえちゃん\nわるく{r[おも]}思{/r}わないでくれよ…
Player_StgWin_226	{r[わる]}悪{/r}いけどまた{r[こんど]}今度{/r}な！この{r[さき]}先{/r}に\nレアスシガミがいるみたいなんだ！
Player_StgWin_227	それってつまりこの{r[さき]}先{/r}に\nなにかがあるってことか？
Player_StgWin_228	{r[さら]}皿{/r}を{r[うば]}奪{/r}われても、それ{r[いじょう]}以上{/r}の{r[さら]}皿{/r}を\n{r[な]}投{/r}げればいいだけだぜ♪
Player_StgWin_233	さっきも{r[い]}言{/r}ったけど\nソスナはもうここにはいないぜ？
Player_StgWin_234	あの～ …{r[あか]}赤{/r}いスシを{r[た]}食{/r}べない{r[けん]}件{/r}\nもうソスナは{r[てっかい]}撤回{/r}しているぞ…？
Player_StgWin_235	な、なんだか{r[けんしんてき]}献身的{/r}すぎて\n{r[な]}泣{/r}けてくるぜ…
Player_StgWin_236	そう{r[い]}言{/r}ってるじゃんか…\nすこしは{r[き]}聞{/r}く{r[みみ]}耳{/r}もってくれよな！
Player_StgWin_237	ソスナの{r[ぶたい]}部隊{/r}はさっき{r[たお]}倒{/r}したから\nそれでここまで{r[こ]}来{/r}られたんだぜ♪
Player_StgWin_238	お、おう… {r[ひつう]}悲痛{/r}な{r[さけ]}叫{/r}びだけど\nごめんな… {r[さき]}先{/r}には{r[い]}行{/r}かせてもらうぜ
Player_StgWin_239	その{r[て]}手{/r}にはひっかからないぜ♪\nこの{r[さき]}先{/r}にほこらがあるんだろ？
Player_StgWin_240	よっしゃ～♪ レアスシガミと\n{r[けいやく]}契約{/r}させてもらうぜ♪
Player_StgWin_249	う～ん… まだこの{r[ちか]}近{/r}くには\n{r[あらわ]}現{/r}れていないみたいだぜ…
Player_StgWin_250	{r[ざんねん]}残念{/r}だけど、まだスシガミの\n{r[けはい]}気配{/r}はぜんぜん{r[かん]}感{/r}じないぜ…
Player_StgWin_251	まあな♪ でもさすがに{r[れんせん]}連戦{/r}が\n{r[つづ]}続{/r}くと{r[いき]}息{/r}が{r[き]}切{/r}れてくるぜ…
Player_StgWin_252	オレをだましたところで\nスシバトルはだませないぜ♪
Player_StgWin_253	スシガミのほこらが{r[よ]}呼{/r}んでいる…\nそんな{r[き]}気{/r}がするんだ♪
Player_StgWin_254	おっちゃんの{r[うん]}運{/r}が{r[つ]}尽{/r}きて\nオレに{r[うん]}運{/r}がめぐってきたぜ♪
Player_StgWin_255	スシガミいるところにムサシあり\n{r[さいきん]}最近{/r}のお{r[き]}気{/r}に{r[い]}入{/r}りワードだぜ♪
Player_StgWin_256	{r[だいす]}大好{/r}きなスシを{r[まえ]}前{/r}にしたら\n{r[さむ]}寒{/r}さなんてふき{r[と]}飛{/r}ぶぜ♪
Player_StgWin_257	ほこらは{r[み]}見{/r}つけるものじゃねえ！\n{r[かん]}感{/r}じ{r[と]}取{/r}るものだ！ なんてな♪
Player_StgWin_258	おうよ♪\nそうさせてもらうぜ！
Player_StgWin_259	こんなに{r[しず]}静{/r}かなところにいたら\nバトルの{r[うで]}腕{/r}がなまりそうだな…
Player_StgWin_260	なんだか{r[へいわ]}平和{/r}そうだな…\nここだけ{r[べつせかい]}別世界{/r}みたいだぜ……
Player_StgWin_261	え～…{r[み]}身{/r}を{r[かく]}隠{/r}す{r[くんれん]}訓練{/r}って…\nかくれんぼだったのか……
Player_StgWin_262	あっ…\n{r[たいちょう]}隊長{/r}さんがオニだったんだな……
Player_StgWin_263	ご、ごめんな… オレ{r[ぶきよう]}不器用{/r}で…\nバトルの{r[て]}手{/r}は{r[ぬ]}抜{/r}けねえんだ…
Player_StgWin_264	き、{r[きんにく]}筋肉{/r}が{r[きょうめい]}共鳴{/r}!?\nマッチョ{r[へいし]}兵士{/r}ってなんだかすげえ…
Player_StgWin_265	お、おう…？\nもうスシバトル{r[かんけい]}関係{/r}ないよな…
Player_StgWin_266	そんなに{r[あか]}明{/r}るく{r[い]}言{/r}われても…\n{r[めいれい]}命令{/r}を{r[むし]}無視{/r}して{r[だいじょうぶ]}大丈夫{/r}なのか？
Player_StgWin_267	{r[ゆくえふめい]}行方不明{/r}の{r[きんにく]}筋肉{/r}さん…\n{r[み]}見{/r}つかるといいな…！
Player_StgWin_268	マッチョのにいちゃん！\n{r[め]}目{/r}を{r[さ]}覚{/r}ましてくれッ!!
Player_StgWin_269	{r[へいたい]}兵隊{/r}さんがいるってことは\nこのさきになにかあるんだろ♪
Player_StgWin_270	あー！ やんちゃとか{r[い]}言{/r}って\n{r[こども]}子供{/r}あつかいしようとしたな！
Player_StgWin_271	{r[れいのうりょく]}霊能力{/r}なんかよりも、{r[じぶん]}自分{/r}の\nスシ{r[すじ]}筋{/r}をみがいたほうがいいぜ♪
Player_StgWin_272	いままでよりも、もっともっと\nスシが{r[す]}好{/r}きになっただけさ♪
Player_StgWin_273	ねえちゃんたち{r[きゅう]}急{/r}に{r[めめ]}女々{/r}しく\nなるからこっちの{r[ちょうし]}調子{/r}がくるうぜ…
Player_StgWin_274	オレが{r[つよ]}強{/r}いんじゃないぜ。\nスシがオレを{r[つよ]}強{/r}くしてくれたんだ♪
Player_StgWin_275	たくさんのライバルたちと\nいっぱいスシバトルしたからな♪
Player_StgWin_276	{r[ま]}負{/r}けた{r[りゆう]}理由{/r}を{r[ぶんせき]}分析{/r}するなんて\nにいちゃんってマメだな～…
Player_StgWin_277	{r[きんにく]}筋肉{/r}は{r[きた]}鍛{/r}えてないけどスシバトルで\n{r[こころ]}心{/r}はたくさん{r[きた]}鍛{/r}えてきたぜ♪
Player_StgWin_278	オバサンって{r[よ]}呼{/r}んだのは{r[あやま]}謝{/r}る…\nだから{r[こども]}子供{/r}あつかいも{r[きんし]}禁止{/r}な！
Player_StgWin_279	そう{r[い]}言{/r}われると{r[ぎゃく]}逆{/r}に{r[き]}気{/r}になる…\nチラッチラッ　え？　{r[み]}見{/r}てないぜ？
Player_StgWin_280	そうだ！　{r[せんそう]}戦争{/r}はなにも{r[う]}生{/r}まねえ！\nだから{r[せんそう]}戦争{/r}を{r[お]}終{/r}わらせたいんだ！！
Player_StgWin_281	お{r[まえ]}前{/r}もスシが{r[す]}好{/r}きなんだよな？\nもっと{r[たの]}楽{/r}しそうに{r[た]}食{/r}べようぜ♪
Player_StgWin_282	{r[ま]}負{/r}けたのはヒラメ{r[きん]}筋{/r}じゃなくて\nにいちゃん{r[じしん]}自身{/r}だと{r[おも]}思{/r}うけど…
Player_StgWin_283	ありきたりなあいさつだけど\n{r[なまえ]}名前{/r}だけでも{r[おぼ]}覚{/r}えてくれよな！
Player_StgWin_284	{r[おとな]}大人{/r}…！？　へへっ、そうさ\nオレも{r[おとな]}大人{/r}の{r[なかまい]}仲間入{/r}りなんだぜ♪
Player_StgWin_285	とうちゃん…{r[わか]}若{/r}い{r[とき]}時{/r}から{r[つよ]}強{/r}かったんだ\nいつかその{r[せなか]}背中{/r}を{r[お]}追{/r}い{r[こ]}越{/r}せるかな…
Player_StgWin_286	あんたたちの{r[でんじほう]}電磁砲{/r}とはなんども\nたたかって{r[たいさく]}対策{/r}もバッチリだぜ♪
Player_StgWin_287	ねえちゃんもムサシ…！？\nどことなくオレに{r[に]}似{/r}ている{r[き]}気{/r}も…
Player_StgWin_288	えーっと…そうだったっけ？\nあんまり{r[おぼ]}覚{/r}えてないや～♪
Player_StgWin_289	{r[かいほうせんせん]}解放戦線{/r}はスシに{r[かんしゃ]}感謝{/r}し{r[たいせつ]}大切{/r}にする\n{r[た]}食{/r}べ{r[かた]}方{/r}で{r[みらい]}未来{/r}を{r[き]}切{/r}り{r[ひら]}開{/r}いていくぜ！
Player_StgWin_290	アブリコスは{r[ぎゃく]}逆{/r}に{r[きんにく]}筋肉{/r}を\n{r[きた]}鍛{/r}えすぎな{r[き]}気{/r}もするけどな…
Player_StgWin_291	{r[こころ]}心{/r}なしか{r[しか]}叱{/r}られることに\nワクワクしていないか…？
Player_StgWin_292	ズルいって…\nスシバトルはそういうものだぞ？
Player_StgWin_293	{r[た]}立{/r}ち{r[ど]}止{/r}まってるヒマはねえんだ！\nとうちゃんにだって{r[ま]}負{/r}けないぜ！！
Player_StgWin_294	その{r[かめん]}仮面{/r}の{r[した]}下{/r}ってどうなってるの？\nちょっとだけ{r[み]}見{/r}せてくれよ♪
Player_StgWin_295	こわっぱ？　こわっぱってなんだ？\nもしや{r[こども]}子供{/r}って{r[いみ]}意味{/r}か？　おーい！
Player_StgWin_296	こちらこそガトアリでした～♪\nチャラオもなかなかヨイツ～だぜ♪
Player_StgWin_297	{r[きんにく]}筋肉{/r}を{r[きた]}鍛{/r}えすぎたのが{r[げんいん]}原因{/r}で\nバトルに{r[ま]}負{/r}けたら{r[ほんまつてんとう]}本末転倒{/r}だぞ…
Player_StgWin_298	{r[あか]}赤{/r}いスシはなにも{r[わる]}悪{/r}くねえ！\n{r[わるもの]}悪者{/r}あつかいはやめろよな！！
Player_StgWin_299	ああ、オレはオレの{r[みち]}道{/r}を{r[すす]}進{/r}んで\nスシの{r[みらい]}未来{/r}を{r[き]}切{/r}り{r[ひら]}開{/r}くぜ…！
Player_StgWin_300	えっ…{r[じぶん]}自分{/r}で{r[かいけつ]}解決{/r}しないのか？\nなんだか{r[おとこ]}男{/r}らしくないな…
Player_StgWin_301	こいつどんだけ{r[しょくよく]}食欲{/r}あるんだ…\nそのうち{r[さら]}皿{/r}まで{r[た]}食{/r}べだしそう……
Player_StgWin_302	お{r[まえ]}前{/r}もムサシ…！？\nどう{r[み]}見{/r}てもオレじゃんか！！
Player_StgWin_C_001	チャレンジけんのパワーを{r[つか]}使{/r}って\n{r[しま]}島{/r}のスシガミたちと{r[いっしょ]}一緒{/r}に{r[たたか]}戦{/r}うぜ！
Player_StgWin_C_002	オレも{r[はじ]}初{/r}めて{r[であ]}出会{/r}ったぜ。\nめずらしいけどかわいいよな♪
Player_StgWin_C_003	ネタガミってなんかダサいぞ…\nだっこスシガミなんてどうだ？
Player_StgWin_C_004	スシのネタが{r[す]}好{/r}きすぎて\nだっこしてるって{r[い]}言{/r}ってるぞ
Player_StgWin_C_005	{r[おく]}奥{/r}にある{r[ほこら]}祠{/r}にスシガミがいるかも\nしれねえんだな！サンキュー！
Player_StgWin_C_006	{r[はじ]}初{/r}めてだっこしてから{r[いちど]}一度{/r}も\n{r[はな]}離{/r}したことがないみたいだぜ？
Player_StgWin_C_007	ネタが{r[いがい]}意外{/r}と{r[おも]}重{/r}いみたいで\nだっこを{r[つづ]}続{/r}けるのも{r[つか]}疲{/r}れるってさ
Player_StgWin_C_008	にいちゃんもネタをだっこして\nスシガミに{r[あゆ]}歩{/r}み{r[よ]}寄{/r}ったらどうだ？
Player_StgWin_C_009	{r[い]}言{/r}いづらいんだけど、\nムキムキコワイっておびえてるぞ…
Player_StgWin_C_010	{r[おく]}奥{/r}の{r[ほこら]}祠{/r}にスシガミがいるんだろ？\nだったら{r[か]}駆{/r}けつけないとな♪
Player_StgWin_C_011	{r[しま]}島{/r}での{r[あらそ]}争{/r}いをやめてくれたら\n{r[なかよ]}仲良{/r}くしてあげてもいいってさ♪
Player_StgWin_C_012	スシガミは{r[りょうて]}両手{/r}がふさがってるし\nオレがねえちゃんをだっこしても…
Player_StgWin_C_013	じゃ、じゃあオレもラブリーな\n{r[ろせん]}路線{/r}のスシライカー{r[めざ]}目指{/r}そうかな…
Player_StgWin_C_014	ねえちゃんに！ドキドキして！\n{r[こころ]}心{/r}が！{r[みだ]}乱{/r}されちゃうぜ…っ！
Player_StgWin_C_015	{r[おく]}奥{/r}の{r[ほこら]}祠{/r}になにがあるってんだ？\nよけいに{r[き]}気{/r}になってきたぞ♪
Player_StgWin_C_016	おっちゃん、{r[み]}見{/r}かけによらず\nかわいいものが{r[す]}好{/r}きなのか？
Player_StgWin_C_017	{r[み]}見{/r}た{r[め]}目{/r}で{r[はんだん]}判断{/r}しちゃダメだぜ！\nオレも！この{r[しま]}島{/r}のスシガミも！
Player_StgWin_C_018	だったらみんなでネタをだっこする\nマネをやってみようぜ♪
Player_StgWin_C_019	スシが{r[す]}好{/r}きならみんな{r[ともだち]}友達{/r}だ♪\n{r[みち]}未知{/r}のスシガミでも{r[かんけい]}関係{/r}ねえぜ♪
Player_StgWin_C_020	{r[ひがん]}悲願{/r}？{r[ゆめ]}夢{/r}の{r[けいかく]}計画{/r}？\n{r[ていこく]}帝国{/r}はなにをするつもりなんだ？
Player_StgWin_C_021	この{r[しま]}島{/r}のスシガミたちも、オレも\nスシを{r[あい]}愛{/r}しているんだから{r[とうぜん]}当然{/r}さ♪
Player_StgWin_C_022	ネタはだっこしたいけど\nこの{r[しま]}島{/r}からは{r[で]}出{/r}たくないってさ♪
Player_StgWin_C_023	おんぶしたらネタが{r[み]}見{/r}えないから\nつらくてもだっこするんだってさ♪
Player_StgWin_C_024	スシネタへの{r[あい]}愛{/r}がおさえきれなくて\nずっと{r[いっしょ]}一緒{/r}にいたいんだって♪
Player_StgWin_C_025	へへっ♪どんなもんだい！\nやったな、スシガミたち！
Player_StgWin_001_f	これがスシバトル…\nスシをたくさん{r[た]}食{/r}べられたわ♪
Player_StgWin_002_f	またまた{r[か]}勝{/r}っちゃったわ！\nスシをたくさん{r[た]}食{/r}べられて{r[しあわ]}幸{/r}せ～♪
Player_StgWin_003_f	どうコジロー！\nレーンドライブギアのチカラは!!
Player_StgWin_004_f	ふふ～ん♪\nスイーツならわたしも{r[だいこうぶつ]}大好物{/r}よ♪♪
Player_StgWin_005_f	{r[でんげき]}電撃{/r}シュート？\nぜんぜんシビれなかったわよ！
Player_StgWin_006_f	ふんっ！\nシールドなんて{r[かんけい]}関係{/r}ないわ!!
Player_StgWin_007_f	ふふっ♪\nすごいスピードバトルだったわ！
Player_StgWin_008_f	どう!?\n{r[こども]}子供{/r}あつかいはやめてもらうわよ！
Player_StgWin_009_f	あなたの{r[とつげき]}突撃{/r}\n{r[みき]}見切{/r}っちゃったもんね♪
Player_StgWin_010_f	カプセルか たしかに{r[べんり]}便利{/r}ね！\nいいものを{r[おし]}教{/r}えてもらったわ♪
Player_StgWin_011_f	{r[とくしゅとくしゅ]}特殊特殊{/r}って{r[い]}言{/r}ってばかりで\nバトルがおろそかだったわよ？
Player_StgWin_012_f	わたしの{r[か]}勝{/r}ちよ！\n{r[さき]}先{/r}に{r[すす]}進{/r}ませてもらうわ♪
Player_StgWin_013_f	わたしは{r[ていこく]}帝国{/r}には{r[はい]}入{/r}らないわ！\n{r[おぼ]}覚{/r}えておきなさいコジロー！！
Player_StgWin_014_f	{r[ふく]}服{/r}はちゃんと{r[き]}着{/r}たほうがいいわよ？
Player_StgWin_015_f	{r[こども]}子供{/r}あつかいはやめてよね！\nたしかに…{r[きんにく]}筋肉{/r}はないけども……
Player_StgWin_016_f	スシライカーにマッチョは\n{r[かんけい]}関係{/r}ある…の？
Player_StgWin_017_f	{r[たいちょう]}隊長{/r}だろうとマッチョだろうと\n{r[た]}立{/r}ちはだかる{r[いじょう]}以上{/r}は{r[かんけい]}関係{/r}ないわ！
Player_StgWin_018_f	これで{r[ぶたい]}部隊{/r}はクビね！\nいっそ{r[ていこく]}帝国{/r}からもぬけちゃえば？
Player_StgWin_019_f	スシが{r[い]}入{/r}れかわっても\n{r[た]}食{/r}べることには{r[か]}変{/r}わりないわ！
Player_StgWin_020_f	わたしと{r[おな]}同{/r}じくらいの\nおんなのこ…!?
Player_StgWin_021_f	あの{r[こ]}子{/r}のことが{r[き]}気{/r}になるわ…\nここは{r[とお]}通{/r}してもらうわよ！
Player_StgWin_022_f	{r[か]}勝{/r}ったんだから{r[とお]}通{/r}してもらうわよ！\nさあ どいてどいて!!
Player_StgWin_023_f	ユーリアが{r[い]}行{/r}ったのは\nこっちで{r[あ]}合{/r}っているの？
Player_StgWin_024_f	この{r[さき]}先{/r}にユーリアがいるの…？
Player_StgWin_025_f	ユーリア… すこしは{r[はなし]}話{/r}を\n{r[き]}聞{/r}いてくれる{r[き]}気{/r}になった？
Player_StgWin_026_f	{r[きんにく]}筋肉{/r}がしぼむわけないでしょ！\nいいから{r[はや]}早{/r}くそこをどいてよね!!
Player_StgWin_027_f	ム、ムテキンニク？\n{r[きんにく]}筋肉{/r}にもいろいろあるのね…
Player_StgWin_028_f	ちょ、ちょっと… {r[ま]}負{/r}けたのに\n{r[いっく]}一句{/r}{r[よ]}詠{/r}んでんじゃないわよ……
Player_StgWin_029_f	{r[きんにく]}筋肉{/r}はえんりょしておくわ\nわたしはスシライカーだからね！
Player_StgWin_030_f	バカじゃないわ！ ユーリアとは\n{r[なかま]}仲間{/r}になれる{r[き]}気{/r}がするの!!
Player_StgWin_031_f	バキューム{r[ぐ]}食{/r}いなんかじゃ\nスシの{r[あじ]}味{/r}が{r[わ]}分{/r}からないでしょ!!
Player_StgWin_032_f	{r[かぜ]}風邪{/r}でもひいているの？\nそういうときは{r[むり]}無理{/r}しないでね？
Player_StgWin_033_f	{r[じぜん]}事前{/r}に{r[めぐすり]}目薬{/r}さしておかないとね！\nバトルには{r[しゅうちゅう]}集中{/r}しないとダメよ♪
Player_StgWin_034_f	{r[あじ]}味{/r}が{r[わ]}分{/r}からないなんて\nスシの{r[たの]}楽{/r}しさが{r[はんげん]}半減{/r}しちゃうわね…
Player_StgWin_035_f	ちょっと、この{r[ぶたい]}部隊{/r}の{r[ひと]}人{/r}たち\n{r[ぜんいん]}全員{/r}が{r[たいちょうふりょう]}体調不良{/r}じゃないの……
Player_StgWin_036_f	あなたにも{r[な]}慣{/r}れてきたわ♪\nシースーマイウ～♪♪
Player_StgWin_037_f	あのおじいさんにゾッコン…\nなの……？
Player_StgWin_038_f	え、えっと… ごめんね？\n{r[な]}泣{/r}かせるつもりは……
Player_StgWin_039_f	ご、ごめん…\nこの{r[ぶたい]}部隊{/r}、やりづらいわ……
Player_StgWin_040_f	あ、あの… よかったら\nわたしも{r[いっしょ]}一緒{/r}に{r[おこ]}怒{/r}られようか…？
Player_StgWin_041_f	どうって…\nふつうに{r[よ]}避{/r}けただけよ？
Player_StgWin_042_f	ワサビが{r[た]}食{/r}べられないからって\n{r[こども]}子供{/r}あつかいしないでよ!!
Player_StgWin_043_f	ワサビは{r[にがて]}苦手{/r}だけども、スシとの\n{r[あいしょう]}相性{/r}は{r[わる]}悪{/r}くない{r[き]}気{/r}がするのよね…
Player_StgWin_044_f	これはワサビ{r[す]}好{/r}きじゃなくて\nもはやワサビ{r[ちゅうどく]}中毒{/r}ね……
Player_StgWin_045_f	ワサビが{r[す]}好{/r}きすぎて、もうなにを\n{r[い]}言{/r}っているのかわからないわ……
Player_StgWin_046_f	ちょり～っす♪\nいいバトルだったわ♪♪
Player_StgWin_047_f	{r[わる]}悪{/r}いわね、おねえさん\n{r[さき]}先{/r}に{r[すす]}進{/r}まないといけないの！
Player_StgWin_048_f	わたしでよければ、おねえさんと\nかくれんぼしても…いいよ？
Player_StgWin_049_f	ナデナデならわたしが\nしてあげないことも…ないわよ？
Player_StgWin_050_f	ム、ムサシちゃん？\nなんだか{r[ちょうし]}調子{/r}がくるうわ……
Player_StgWin_051_f	{r[しゅっせ]}出世{/r}ばかり{r[き]}気{/r}にしてても\n{r[しゅっせ]}出世{/r}はできないと{r[おも]}思{/r}うわよ？
Player_StgWin_052_f	ワサビが{r[た]}食{/r}べられるようになれば\n{r[こども]}子供{/r}あつかいされなくなるかな？
Player_StgWin_053_f	グロム… ウワサに{r[き]}聞{/r}く\n{r[ていこくいち]}帝国一{/r}のスシライカー……
Player_StgWin_054_f	{r[す]}好{/r}き{r[きら]}嫌{/r}いは{r[よ]}良{/r}くないわよ？
Player_StgWin_055_f	{r[こども]}子供{/r}あつかい{r[きんし]}禁止{/r}って{r[ちゅういが]}注意書{/r}きも\n{r[た]}足{/r}すように{r[つた]}伝{/r}えておいてよね！
Player_StgWin_056_f	わざわざ{r[ちゅうい]}注意{/r}してくれて\nありがとね♪
Player_StgWin_057_f	え、えっと… わたしはヨイツーな\nシースーのライカーよ……かな？
Player_StgWin_058_f	{r[だれ]}誰{/r}が{r[あいて]}相手{/r}だろうと、ここで{r[あし]}足{/r}を\n{r[と]}止{/r}めるわけにはいかないのよ！
Player_StgWin_059_f	エリートだろうとなんだろうと\nスシはみんなに{r[びょうどう]}平等{/r}なのよ♪
Player_StgWin_060_f	でもグロム{r[たい]}隊{/r}はエリートなんだから\n{r[か]}勝{/r}てたならいい{r[き]}気{/r}になっちゃうよ？
Player_StgWin_061_f	エリートエリートって\nもう{r[き]}聞{/r}き{r[あ]}飽{/r}きちゃった…
Player_StgWin_062_f	ちょっとビックリしたけど、\n{r[おお]}大{/r}きければいいものでもないわ！
Player_StgWin_063_f	ふふ～ん♪ グロムのいどころまで\nノンストップでつきすすむわよ！
Player_StgWin_064_f	{r[あっしゅくじんけい]}圧縮陣形{/r}？ {r[てき]}敵{/r}さんの{r[はいち]}配置{/r}が\nやたら{r[ちか]}近{/r}いのはそのせいね…
Player_StgWin_065_f	スシは{r[ひと]}人{/r}を{r[えがお]}笑顔{/r}にするものよ♪\n{r[たの]}楽{/r}しんで{r[た]}食{/r}べないと♪♪
Player_StgWin_066_f	あのデッケー{r[たいほう]}大砲{/r}のことかしら？\nそれならもうなれっこよ♪
Player_StgWin_067_f	{r[みち]}道{/r}をあけてもらうわよ！\nグロムを{r[お]}追{/r}いかけないと…！
Player_StgWin_068_f	パーティが{r[ひら]}開{/r}けなくなって\n{r[わる]}悪{/r}いことしちゃったかな？
Player_StgWin_069_f	{r[い]}言{/r}い{r[わけ]}訳{/r}するなんて\n{r[おとこ]}男{/r}らしくないわね！
Player_StgWin_070_f	あなたがスシを{r[す]}好{/r}きなことは\n{r[たたか]}戦{/r}っていて{r[つた]}伝{/r}わってきたわよ♪
Player_StgWin_071_f	まだいるかもしれない！\n{r[さき]}先{/r}に{r[い]}行{/r}かせてもらうわよ!!
Player_StgWin_072_f	{r[うれ]}嬉{/r}しい{r[ごさん]}誤算{/r}ですって!?\n{r[いったい]}一体{/r}なにを{r[い]}言{/r}っているの!!
Player_StgWin_073_f	スシは{r[ごうりせい]}合理性{/r}どうこうじゃない！\nおいしく{r[ぜんぶ]}全部{/r}を{r[た]}食{/r}べるものよ!!
Player_StgWin_074_f	{r[わる]}悪{/r}いわね、おじさん\n{r[さき]}先{/r}に{r[い]}行{/r}かせてもらうわよ！
Player_StgWin_075_f	そう！ わたしがムサシよ！\nもしかしてちょっと{r[ゆうめいじん]}有名人{/r}？
Player_StgWin_076_f	トドメなんてささないわよ\nそれじゃまるで{r[あくやく]}悪役{/r}だわ
Player_StgWin_077_f	ん？ {r[か]}勝{/r}っても{r[あじ]}味{/r}なんてしないけど\n{r[ま]}負{/r}けると{r[あじ]}味{/r}がするの??
Player_StgWin_078_f	シースー？ ムーゲー??\n{r[いったい]}一体{/r}なんなの…??
Player_StgWin_079_f	なんなのこの{r[ひと]}人{/r}？\n{r[しか]}叱{/r}られるのに{r[よろこ]}喜{/r}んでるわよ??
Player_StgWin_080_f	こ、この{r[ひと]}人{/r}もおかしいわ…。\n{r[しか]}叱{/r}ってくれってお{r[ねが]}願{/r}いするなんて
Player_StgWin_081_f	……。\nあのオバサンの{r[ぶか]}部下{/r}、{r[だいじょうぶ]}大丈夫{/r}なの…
Player_StgWin_082_f	た、{r[たいちょう]}隊長{/r}が{r[いちばん]}一番{/r}{r[しんぱい]}心配{/r}な{r[ひと]}人{/r}だったわ…
Player_StgWin_083_f	たしかにちょっと{r[くせん]}苦戦{/r}したけど…\nわたしは{r[ま]}負{/r}けられないの!!
Player_StgWin_084_f	ソスナって{r[ひと]}人{/r}の{r[ぶか]}部下{/r}たちは\n{r[あか]}赤{/r}いスシを{r[た]}食{/r}べると{r[おこ]}怒{/r}られるのね…
Player_StgWin_085_f	{r[あか]}赤{/r}いスシが{r[つよ]}強{/r}いんじゃないわ！\nバランスよく{r[た]}食{/r}べるから{r[つよ]}強{/r}いのよ！
Player_StgWin_086_f	{r[いじ]}意地{/r}はってないで\n{r[あか]}赤{/r}いスシも{r[た]}食{/r}べちゃえば？
Player_StgWin_087_f	{r[むり]}無理{/r}に{r[あか]}赤{/r}いスシをガマンするから\nスシの{r[まぼろし]}幻{/r}が{r[み]}見{/r}えちゃってるのね…
Player_StgWin_088_f	シースーがマイウーでガトアリ…\nうう… {r[こんらん]}混乱{/r}してくるわ……
Player_StgWin_089_f	{r[ぶか]}部下{/r}がスシバトルをしているときに\n{r[じぶん]}自分{/r}は{r[ゆうが]}優雅{/r}にスイーツなのね…
Player_StgWin_090_f	{r[はや]}早{/r}く{r[い]}行{/r}きたかったからバトル{r[ちゅう]}中{/r}\nずっとソワソワしていたの？
Player_StgWin_091_f	そっか…\nあなたたちも{r[くろう]}苦労{/r}してるのね……
Player_StgWin_092_f	ん？\nソスナがなんですって？
Player_StgWin_093_f	い、いや、うらみはないけど\n{r[しょうぶ]}勝負{/r}を{r[いど]}挑{/r}んでくるから……
Player_StgWin_094_f	ふふ～ん♪ {r[あか]}赤{/r}いスシ{r[いがい]}以外{/r}の\nスシだってあるんだもんね♪♪
Player_StgWin_095_f	はくしょん…！\nた、たしかに{r[さむ]}寒{/r}いわね……
Player_StgWin_096_f	え、ええ…！ いさぎよいわね！\nしっかり{r[あたた]}暖{/r}まってきてね!!
Player_StgWin_097_f	こっちだって{r[さむ]}寒{/r}いわよ！\nなんなのよここは!!
Player_StgWin_098_f	うまいこと{r[い]}言{/r}った……のかな？
Player_StgWin_099_f	あーー！ そのセリフは!!\nおじさんのこと{r[おも]}思{/r}い{r[だ]}出{/r}したわ!!
Player_StgWin_100_f	あ！ {r[おも]}思{/r}い{r[だ]}出{/r}した！ {r[ふく]}服{/r}はちゃんと{r[き]}着{/r}て\nってアドバイスしたじゃない!!
Player_StgWin_101_f	ええ！ バトルをたくさんして\n{r[きんにく]}筋肉{/r}だってちょっぴり{r[つ]}付{/r}いたわ!!
Player_StgWin_102_f	マッチョのこだわりはどうしても\n{r[す]}捨{/r}てられない{r[ひと]}人{/r}たちなのね……
Player_StgWin_103_f	わ、わたしが{r[しん]}真{/r}のマッチョ…？\nそれって… {r[よろこ]}喜{/r}んでいい……の??
Player_StgWin_104_f	えー、だって{r[ほんとう]}本当{/r}のことを\n{r[い]}言{/r}ったまでじゃん～
Player_StgWin_105_f	{r[め]}目{/r}を{r[さ]}覚{/r}まして！ あんなやり{r[かた]}方{/r}で\n{r[つよ]}強{/r}くなれるわけがないでしょッ！！
Player_StgWin_106_f	あ！ {r[きんにく]}筋肉{/r}しぼむ{r[ひと]}人{/r}!!\nおにいさんは{r[じゅうぶん]}十分{/r}マッチョだよ!!
Player_StgWin_107_f	わあ！ {r[こんど]}今度{/r}はムテキンニクの{r[ひと]}人{/r}!!\nアブリコス{r[たい]}隊{/r}が{r[せい]}勢{/r}ぞろいなの!?
Player_StgWin_108_f	{r[きんにく]}筋肉{/r}{r[はいく]}俳句{/r}の{r[ひと]}人{/r}も{r[おぼ]}覚{/r}えてるわよ！\nなんだか{r[しんり]}真理{/r}にたどり{r[つ]}着{/r}いた…？
Player_StgWin_109_f	マッチョも{r[たの]}楽{/r}しそうに{r[おも]}思{/r}えてきて\nちょっと{r[かんが]}考{/r}えちゃうなあ…
Player_StgWin_110_f	ユキチさんを{r[たす]}助{/r}けたいの！\n{r[とお]}通{/r}してもらうわよ!!
Player_StgWin_111_f	もうやめてアブリコス！\nそんな{r[た]}食{/r}べ{r[かた]}方{/r}はスシに{r[しつれい]}失礼{/r}だわ!!
Player_StgWin_112_f	そ、そうなの？\nあんまり{r[き]}気{/r}に{r[や]}病{/r}まないでね…？
Player_StgWin_113_f	あれ？ さっきも{r[じぶん]}自分{/r}のことを\n{r[さいじゃく]}最弱{/r}って{r[い]}言{/r}う{r[ひと]}人{/r}がいたような…？
Player_StgWin_114_f	この{r[ぶたい]}部隊{/r}の{r[ひと]}人{/r}たち\nみんな{r[い]}言{/r}い{r[わけ]}訳{/r}が{r[おな]}同{/r}じね…
Player_StgWin_115_f	おじさんが{r[いちばん]}一番{/r}{r[よわ]}弱{/r}いの…？\nいったい{r[だれ]}誰{/r}が{r[ほんとう]}本当{/r}の{r[さいじゃく]}最弱{/r}なの……
Player_StgWin_116_f	わたしもあなたとバトルをするのが\n{r[あ]}当{/r}たり{r[まえ]}前{/r}に{r[おも]}思{/r}えてきたわ♪
Player_StgWin_117_f	ルツコイさんね…\nどんなスシバトルか{r[たの]}楽{/r}しみだわ♪
Player_StgWin_118_f	{r[こんど]}今度{/r}はマツイさんね…\n{r[つぎ]}次{/r}の{r[ひと]}人{/r}に{r[たく]}託{/r}す{r[かん]}感{/r}じなのかしら…？
Player_StgWin_119_f	この{r[ぶたい]}部隊{/r}の{r[へいたい]}兵隊{/r}さんたちは\nなんだかみんな{r[ひとまか]}人任{/r}せのような…
Player_StgWin_120_f	{r[たいちょう]}隊長{/r}さんはみんなの{r[せきにん]}責任{/r}が\nのしかかって{r[たいへん]}大変{/r}そうね…
Player_StgWin_121_f	{r[ひみつへいき]}秘密兵器{/r}なんだっけ？\n{r[わる]}悪{/r}いわね、{r[こわ]}壊{/r}しちゃって！
Player_StgWin_122_f	マッチョはマッチョで{r[たいへん]}大変{/r}そうだし\nやめといたほうがいい{r[き]}気{/r}が…
Player_StgWin_123_f	ワ、ワサビは{r[かんべん]}勘弁{/r}して～！\nあれはツーンとして{r[にがて]}苦手{/r}なのよ…
Player_StgWin_124_f	{r[むり]}無理{/r}にガマンするのは{r[よ]}良{/r}くないよ？\n{r[た]}食{/r}べたいスシを{r[た]}食{/r}べないとね！
Player_StgWin_125_f	エレガントさを{r[もと]}求{/r}める{r[まえ]}前{/r}に\nまずはスシを{r[しん]}信{/r}じるところからね
Player_StgWin_126_f	スシ{r[すじ]}筋{/r}…？ スシのあつかいかたを\n{r[さ]}指{/r}す{r[ことば]}言葉{/r}？ ……カッコイイわね！
Player_StgWin_127_f	スシを{r[あい]}愛{/r}しているのね…\nとうさん、いい{r[ぶか]}部下{/r}じゃない……
Player_StgWin_128_f	ええ、これがわたしのスシバトル！\nスシへの{r[かんしゃ]}感謝{/r}なら{r[だれ]}誰{/r}にも{r[ま]}負{/r}けない！
Player_StgWin_129_f	とうさんに{r[あ]}会{/r}って{r[はなし]}話{/r}をするの！\n{r[た]}立{/r}ち{r[ど]}止{/r}まるわけにはいかないわ!!
Player_StgWin_130_f	{r[へいたい]}兵隊{/r}だろうが{r[たいほう]}大砲{/r}だろうが\n{r[た]}立{/r}ちはだかるなら{r[う]}打{/r}ち{r[か]}勝{/r}つまでよ！
Player_StgWin_131_f	どうとうさん！\nこれがわたしのスシよッ！！
Player_StgWin_132_f	な、なに？ お{r[めん]}面{/r}なのそれ？\nちょっと{r[こわ]}怖{/r}いわね……
Player_StgWin_133_f	{r[い]}行{/r}き{r[ど]}止{/r}まりのワケないじゃない！\nウソだってバレバレよ！！
Player_StgWin_134_f	ずっと{r[おな]}同{/r}じコトを{r[い]}言{/r}っているわ…\nさ、{r[さき]}先{/r}に{r[い]}行{/r}かせてもらいま～す……
Player_StgWin_135_f	ひ、ひえっ…\nこの{r[ぶたい]}部隊{/r}、なんだかやばいわ……
Player_StgWin_136_f	こんなところにも{r[あらわ]}現{/r}れるなんて\n{r[ほんとう]}本当{/r}になにものなの……
Player_StgWin_137_f	また{r[こども]}子供{/r}あつかい！ やめてよね\nとうさんの{r[まえ]}前{/r}なんだから…
Player_StgWin_138_f	{r[せいちょう]}成長{/r}したわたしの{r[すがた]}姿{/r}をとうさんに\n{r[み]}見{/r}せたくてがんばってるのよ！
Player_StgWin_139_f	そんな{r[けいかく]}計画{/r}、わたしととうさんで\n{r[こわ]}壊{/r}してあげるわ!!
Player_StgWin_140_f	グラードはこの{r[さき]}先{/r}なの！？\n{r[い]}行{/r}こう、とうさん!!
Player_StgWin_141_f	あなたたちがやろうとしている\nスシの{r[しはい]}支配{/r}なんて{r[みと]}認{/r}めないわよ！
Player_StgWin_142_f	{r[はや]}早{/r}くとうさんを{r[お]}追{/r}いかけないと！\n{r[わる]}悪{/r}いけど{r[さき]}先{/r}に{r[い]}行{/r}かせてもらうわよ！
Player_StgWin_143_f	{r[ていこく]}帝国{/r}のやり{r[かた]}方{/r}じゃ、{r[わら]}笑{/r}ってみんなで\nスシを{r[た]}食{/r}べられないのよ！
Player_StgWin_144_f	グラードに{r[あ]}会{/r}わせてもらうわよ\nスシの{r[みらい]}未来{/r}を{r[はな]}話{/r}し{r[あ]}合{/r}いにきたの！
Player_StgWin_145_f	スシは{r[だれ]}誰{/r}かのものじゃない！\nみんなのものよ!!
Player_StgWin_146_f	みんなで{r[わら]}笑{/r}っておいしく{r[た]}食{/r}べる！\nそれがわたしの{r[かんが]}考{/r}えるスシよ！！
Player_StgWin_197_f	この{r[いし]}石{/r}は{r[わた]}渡{/r}せないわ！\n{r[ほ]}欲{/r}しければ{r[じぶん]}自分{/r}で{r[さが]}探{/r}してね♪
Player_StgWin_198_f	おじさん… {r[ま]}負{/r}けたのに\nダジャレを{r[い]}言{/r}っている{r[ばあい]}場合{/r}なの？
Player_StgWin_199_f	{r[じんじゃ]}神社{/r}… そこにレーンドライブギアを\n{r[つく]}作{/r}る{r[ぎし]}技師{/r}がいるの？
Player_StgWin_200_f	ふふ～ん♪ こっちには{r[ゆうしゅう]}優秀{/r}な\n{r[じょうほうつう]}情報通{/r}がついているのよ♪
Player_StgWin_201_f	マ、マッチョじゃないし！\nスシライカーのムサシよ!!
Player_StgWin_202_f	マッチョ～ マッチョ～…\nってなにやらせるのよ…!!
Player_StgWin_203_f	そのおじさんよりわたしのほうが\n{r[いちまいうわて]}一枚上手{/r}だったってことね♪
Player_StgWin_204_f	ん？ そのセリフ…\nさっきも{r[き]}聞{/r}いたような……
Player_StgWin_205_f	ここの{r[たいちょう]}隊長{/r}さんは、みんなのことを\n{r[さいきょう]}最強{/r}だって{r[い]}言{/r}っているの…？
Player_StgWin_206_f	そういう{r[ほうしん]}方針{/r}だったのね…\nギアは{r[ぜったい]}絶対{/r}に{r[と]}取{/r}り{r[かえ]}返{/r}すわ…！
Player_StgWin_209_f	{r[だれ]}誰{/r}が{r[た]}立{/r}ちはだかろうと\nスシを{r[しん]}信{/r}じてバトルするだけよ！
Player_StgWin_210_f	あやしい{r[じっけん]}実験{/r}をしてるって{r[き]}聞{/r}いたわ\nそれが{r[ほんとう]}本当{/r}ならわたしが{r[と]}止{/r}める!!
Player_StgWin_211_f	その{r[とお]}通{/r}り♪\n{r[ぬす]}盗{/r}んだものを{r[かえ]}返{/r}してもらうわ！
Player_StgWin_212_f	その{r[はつめい]}発明{/r}のためだったら{r[ひと]}人{/r}のものを\n{r[ぬす]}盗{/r}んでいいってわけじゃないわよ！
Player_StgWin_213_f	{r[さいじゃく]}最弱{/r}かどうかは{r[わ]}分{/r}からないけど\n{r[だいじ]}大事{/r}なのはスシを{r[しん]}信{/r}じる{r[こころ]}心{/r}よ！
Player_StgWin_214_f	あ、あれ？\nこの{r[なが]}流{/r}れ… {r[まえ]}前{/r}にもあったような…
Player_StgWin_215_f	もしかしてこの{r[たい]}隊{/r}は\nたたいて{r[の]}伸{/r}ばす{r[ほうしん]}方針{/r}なんじゃ…？
Player_StgWin_216_f	なんだかおじさんさみしそう…\n{r[ぶか]}部下{/r}の{r[いくせい]}育成{/r}も{r[たいへん]}大変{/r}なのね……
Player_StgWin_217_f	その{r[しせつ]}施設{/r}に{r[い]}行{/r}くために{r[き]}来{/r}たのよ！\n{r[でんじほう]}電磁砲{/r}まであるなんてあやしいわ！
Player_StgWin_218_f	スシを{r[そまつ]}粗末{/r}にする{r[じっけん]}実験{/r}の{r[しせつ]}施設{/r}なんて\n{r[みと]}認{/r}めるわけにはいかないわ!!
Player_StgWin_219_f	{r[じんこう]}人工{/r}スシゲートなんかで\n{r[ほんとう]}本当{/r}の{r[しあわ]}幸{/r}せがやってくるはずない！
Player_StgWin_221_f	おじさんは{r[じぶん]}自分{/r}の{r[くち]}口{/r}のかたさを\n{r[うたが]}疑{/r}ったほうがいいかもよ…？
Player_StgWin_222_f	{r[い]}行{/r}くなと{r[い]}言{/r}われると\n{r[い]}行{/r}きたくなっちゃうわよね♪
Player_StgWin_223_f	じゃあ{r[わる]}悪{/r}いけど\nしかられてね♪
Player_StgWin_224_f	レアスシガミのゴクオウ\nわたしがもらい{r[う]}受{/r}けるわ！
Player_StgWin_225_f	ご、ごめんね、おねえさん\nわるく{r[おも]}思{/r}わないでね…
Player_StgWin_226_f	{r[わる]}悪{/r}いけどまた{r[こんど]}今度{/r}ね！ この{r[さき]}先{/r}に\nレアスシガミがいるみたいなの！
Player_StgWin_227_f	それってつまりこの{r[さき]}先{/r}に\nなにかがあるってこと？
Player_StgWin_228_f	{r[さら]}皿{/r}を{r[うば]}奪{/r}われても、それ{r[いじょう]}以上{/r}の{r[さら]}皿{/r}を\n{r[な]}投{/r}げればいいだけよ♪
Player_StgWin_233_f	さっきも{r[い]}言{/r}ったけど\nソスナはもうここにはいないわよ？
Player_StgWin_234_f	あの～ …{r[あか]}赤{/r}いスシを{r[た]}食{/r}べない{r[けん]}件{/r}\nもうソスナは{r[てっかい]}撤回{/r}しているわよ…？
Player_StgWin_235_f	な、なんだか{r[けんしんてき]}献身的{/r}すぎて\n{r[な]}泣{/r}けてくるわ…
Player_StgWin_236_f	そう{r[い]}言{/r}ってるじゃない…\nすこしは{r[き]}聞{/r}く{r[みみ]}耳{/r}もってよね！
Player_StgWin_237_f	ソスナの{r[ぶたい]}部隊{/r}はさっき{r[たお]}倒{/r}したから\nそれでここまで{r[こ]}来{/r}られたのよ♪
Player_StgWin_238_f	え、ええ… {r[ひつう]}悲痛{/r}な{r[さけ]}叫{/r}びだけど\nごめん… {r[さき]}先{/r}には{r[い]}行{/r}かせてもらうわ
Player_StgWin_239_f	その{r[て]}手{/r}にはひっかからないわよ♪\nこの{r[さき]}先{/r}にほこらがあるんでしょ？
Player_StgWin_240_f	よっしゃ～♪ レアスシガミと\n{r[けいやく]}契約{/r}させてもらうわよ♪
Player_StgWin_249_f	う～ん… まだこの{r[ちか]}近{/r}くには\n{r[あらわ]}現{/r}れていないみたい…
Player_StgWin_250_f	{r[ざんねん]}残念{/r}だけど、まだスシガミの\n{r[けはい]}気配{/r}はぜんぜん{r[かん]}感{/r}じないわ…
Player_StgWin_251_f	まあね♪ でもさすがに{r[れんせん]}連戦{/r}が\n{r[つづ]}続{/r}くと{r[いき]}息{/r}が{r[き]}切{/r}れてくるわ…
Player_StgWin_252_f	わたしをだましたところで\nスシバトルはだませないわよ♪
Player_StgWin_253_f	スシガミのほこらが{r[よ]}呼{/r}んでいる…\nそんな{r[き]}気{/r}がするの♪
Player_StgWin_254_f	おじさんの{r[うん]}運{/r}が{r[つ]}尽{/r}きて\nわたしに{r[うん]}運{/r}がめぐってきたわ♪
Player_StgWin_255_f	スシガミいるところにムサシあり\n{r[さいきん]}最近{/r}のお{r[き]}気{/r}に{r[い]}入{/r}りワードよ♪
Player_StgWin_256_f	{r[だいす]}大好{/r}きなスシを{r[まえ]}前{/r}にしたら\n{r[さむ]}寒{/r}さなんてふき{r[と]}飛{/r}ぶわ♪
Player_StgWin_257_f	ほこらは{r[み]}見{/r}つけるものじゃない！\n{r[かん]}感{/r}じ{r[と]}取{/r}るものよ！ なんてね♪
Player_StgWin_258_f	もっちろん♪\nそうさせてもらうわ！
Player_StgWin_259_f	こんなに{r[しず]}静{/r}かなところにいたら\nバトルの{r[うで]}腕{/r}がなまりそうね…
Player_StgWin_260_f	なんだか{r[へいわ]}平和{/r}そうね…\nここだけ{r[べつせかい]}別世界{/r}みたい……
Player_StgWin_261_f	え～…{r[み]}身{/r}を{r[かく]}隠{/r}す{r[くんれん]}訓練{/r}って…\nかくれんぼだったのね……
Player_StgWin_262_f	あっ…\n{r[たいちょう]}隊長{/r}さんがオニだったんだ……
Player_StgWin_263_f	ご、ごめんね… わたし{r[ぶきよう]}不器用{/r}で…\nバトルの{r[て]}手{/r}は{r[ぬ]}抜{/r}けないの…
Player_StgWin_264_f	き、{r[きんにく]}筋肉{/r}が{r[きょうめい]}共鳴{/r}!?\nマッチョ{r[へいし]}兵士{/r}ってなんだかすごい…
Player_StgWin_265_f	そ、そう…？\nもうスシバトル{r[かんけい]}関係{/r}ないよね…
Player_StgWin_266_f	そんなに{r[あか]}明{/r}るく{r[い]}言{/r}われても…\n{r[めいれい]}命令{/r}を{r[むし]}無視{/r}して{r[だいじょうぶ]}大丈夫{/r}なの？
Player_StgWin_267_f	{r[ゆくえふめい]}行方不明{/r}の{r[きんにく]}筋肉{/r}さん…\n{r[み]}見{/r}つかるといいわね…！
Player_StgWin_268_f	マッチョのおにいさん！\n{r[め]}目{/r}を{r[さ]}覚{/r}ましてッ!!
Player_StgWin_269_f	{r[へいたい]}兵隊{/r}さんがいるってことは\nこのさきになにかあるんでしょ♪
Player_StgWin_270_f	あー！ やんちゃとか{r[い]}言{/r}って\n{r[こども]}子供{/r}あつかいしようとしたわね！
Player_StgWin_271_f	{r[れいのうりょく]}霊能力{/r}なんかよりも、{r[じぶん]}自分{/r}の\nスシ{r[すじ]}筋{/r}をみがいたほうがいいわよ♪
Player_StgWin_272_f	いままでよりも、もっともっと\nスシが{r[す]}好{/r}きになっただけよ♪
Player_StgWin_273_f	おねえさんたち{r[きゅう]}急{/r}に{r[めめ]}女々{/r}しく\nなるからこっちの{r[ちょうし]}調子{/r}がくるうわ…
Player_StgWin_274_f	わたしが{r[つよ]}強{/r}いんじゃないわ。\nスシがわたしを{r[つよ]}強{/r}くしてくれたの♪
Player_StgWin_275_f	たくさんのライバルたちと\nいっぱいスシバトルしたからね♪
Player_StgWin_276_f	{r[ま]}負{/r}けた{r[りゆう]}理由{/r}を{r[ぶんせき]}分析{/r}するなんて\nおにいさんってマメなのね…
Player_StgWin_277_f	{r[きんにく]}筋肉{/r}は{r[きた]}鍛{/r}えてないけどスシバトルで\n{r[こころ]}心{/r}はたくさん{r[きた]}鍛{/r}えてきたわ♪
Player_StgWin_278_f	オバサンって{r[よ]}呼{/r}んだのは{r[あやま]}謝{/r}るわ…\nだから{r[こども]}子供{/r}あつかいも{r[きんし]}禁止{/r}ね！
Player_StgWin_279_f	そう{r[い]}言{/r}われると{r[ぎゃく]}逆{/r}に{r[き]}気{/r}になる…\nチラッチラッ　え？　{r[み]}見{/r}てないよ？
Player_StgWin_280_f	そうよ！　{r[せんそう]}戦争{/r}はなにも{r[う]}生{/r}まない！\nだから{r[せんそう]}戦争{/r}を{r[お]}終{/r}わらせたいの！！
Player_StgWin_281_f	あなたもスシが{r[す]}好{/r}きなのよね？\nもっと{r[たの]}楽{/r}しそうに{r[た]}食{/r}べましょうよ♪
Player_StgWin_282_f	{r[ま]}負{/r}けたのはヒラメ{r[きん]}筋{/r}じゃなくて\nおにいさん{r[じしん]}自身{/r}だと{r[おも]}思{/r}うけど…
Player_StgWin_283_f	ありきたりなあいさつだけど\n{r[なまえ]}名前{/r}だけでも{r[おぼ]}覚{/r}えていってね！
Player_StgWin_284_f	{r[おとな]}大人{/r}…！？　ふふっ、そうよ\nわたしも{r[おとな]}大人{/r}の{r[なかまい]}仲間入{/r}りなの♪
Player_StgWin_285_f	とうさん…{r[わか]}若{/r}い{r[とき]}時{/r}から{r[つよ]}強{/r}かったのね\nいつかその{r[せなか]}背中{/r}を{r[お]}追{/r}い{r[こ]}越{/r}せるかな…
Player_StgWin_286_f	あなたたちの{r[でんじほう]}電磁砲{/r}とはなんども\nたたかって{r[たいさく]}対策{/r}もバッチリなのよ♪
Player_StgWin_287_f	おねえさんもムサシ…？\nどう{r[み]}見{/r}てもわたしじゃん！！
Player_StgWin_288_f	えーっと…そうだったっけ？\nあんまり{r[おぼ]}覚{/r}えてないや～♪
Player_StgWin_289_f	{r[かいほうせんせん]}解放戦線{/r}はスシに{r[かんしゃ]}感謝{/r}し{r[たいせつ]}大切{/r}にする\n{r[た]}食{/r}べ{r[かた]}方{/r}で{r[みらい]}未来{/r}を{r[き]}切{/r}り{r[ひら]}開{/r}いていくわ！
Player_StgWin_290_f	アブリコスは{r[ぎゃく]}逆{/r}に{r[きんにく]}筋肉{/r}を\n{r[きた]}鍛{/r}えすぎな{r[き]}気{/r}もするけどね…
Player_StgWin_291_f	{r[こころ]}心{/r}なしか{r[しか]}叱{/r}られることに\nワクワクしていない…？
Player_StgWin_292_f	ズルいって…\nスシバトルはそういうものよ？
Player_StgWin_293_f	{r[た]}立{/r}ち{r[ど]}止{/r}まってるヒマはないの！\nとうさんにだって{r[ま]}負{/r}けないわよ！！
Player_StgWin_294_f	その{r[かめん]}仮面{/r}の{r[した]}下{/r}ってどうなってるの？\nちょっとだけ{r[み]}見{/r}せてよ♪
Player_StgWin_295_f	こわっぱ？　こわっぱってなに？\nもしや{r[こども]}子供{/r}って{r[いみ]}意味{/r}？　ねえ！
Player_StgWin_296_f	こちらこそガトアリでした～♪\nチャラオもなかなかヨイツ～だよ♪
Player_StgWin_297_f	{r[きんにく]}筋肉{/r}を{r[きた]}鍛{/r}えすぎたのが{r[げんいん]}原因{/r}で\nバトルに{r[ま]}負{/r}けたら{r[ほんまつてんとう]}本末転倒{/r}よね…
Player_StgWin_298_f	{r[あか]}赤{/r}いスシはなにも{r[わる]}悪{/r}くない！\n{r[わるもの]}悪者{/r}あつかいはやめてよね！！
Player_StgWin_299_f	ええ、わたしはわたしの{r[みち]}道{/r}を{r[すす]}進{/r}んで\nスシの{r[みらい]}未来{/r}を{r[き]}切{/r}り{r[ひら]}開{/r}くわ…！
Player_StgWin_300_f	えっ…{r[じぶん]}自分{/r}で{r[かいけつ]}解決{/r}しないの？\nなんだか{r[おとこ]}男{/r}らしくないわね…
Player_StgWin_301_f	この{r[ひと]}人{/r}どれだけ{r[しょくよく]}食欲{/r}あるのよ…\nそのうち{r[さら]}皿{/r}まで{r[た]}食{/r}べだしそうね……
Player_StgWin_302_f	キミもムサシ…？\nどことなくわたしに{r[に]}似{/r}ている{r[き]}気{/r}も…
Player_StgWin_C_001_f	チャレンジけんのパワーを{r[つか]}使{/r}って\n{r[しま]}島{/r}のスシガミたちと{r[いっしょ]}一緒{/r}に{r[たたか]}戦{/r}うわ！
Player_StgWin_C_002_f	わたしも{r[はじ]}初{/r}めて{r[であ]}出会{/r}ったわ。\nめずらしいけどかわいいよね♪
Player_StgWin_C_003_f	ネタガミってなんかダサいわね…\nだっこスシガミなんてどう？
Player_StgWin_C_004_f	スシのネタが{r[す]}好{/r}きすぎて\nだっこしてるって{r[い]}言{/r}ってるわよ
Player_StgWin_C_005_f	{r[おく]}奥{/r}にある{r[ほこら]}祠{/r}にスシガミがいるかも\nしれないのね！ありがと！
Player_StgWin_C_006_f	{r[はじ]}初{/r}めてだっこしてから{r[いちど]}一度{/r}も\n{r[はな]}離{/r}したことがないみたいよ？
Player_StgWin_C_007_f	ネタが{r[いがい]}意外{/r}と{r[おも]}重{/r}いみたいで\nだっこを{r[つづ]}続{/r}けるのも{r[つか]}疲{/r}れるそうよ
Player_StgWin_C_008_f	おにいさんもネタをだっこして\nスシガミに{r[あゆ]}歩{/r}み{r[よ]}寄{/r}ったらどう？
Player_StgWin_C_009_f	{r[い]}言{/r}いづらいんだけど、\nムキムキコワイっておびえてるわ…
Player_StgWin_C_010_f	{r[おく]}奥{/r}の{r[ほこら]}祠{/r}にスシガミがいるんでしょ？\nだったら{r[か]}駆{/r}けつけないとね♪
Player_StgWin_C_011_f	{r[しま]}島{/r}での{r[あらそ]}争{/r}いをやめてくれたら\n{r[なかよ]}仲良{/r}くしてあげてもいいって♪
Player_StgWin_C_012_f	スシガミはおねえさんよりも\nネタのほうが{r[す]}好{/r}きみたいよ？
Player_StgWin_C_013_f	なによラブリーとか{r[い]}言{/r}っちゃって！\nわたしだってかわいいの{r[す]}好{/r}きだし！
Player_StgWin_C_014_f	いい{r[とし]}年{/r}のくせに、かわいいもの{r[み]}見{/r}て\nモジモジしないでよねっ！ふんだ！
Player_StgWin_C_015_f	{r[おく]}奥{/r}の{r[ほこら]}祠{/r}になにがあるっていうの？\nよけいに{r[き]}気{/r}になってきたわ♪
Player_StgWin_C_016_f	おじさん、{r[み]}見{/r}かけによらず\nかわいいものが{r[す]}好{/r}きなの？
Player_StgWin_C_017_f	{r[み]}見{/r}た{r[め]}目{/r}で{r[はんだん]}判断{/r}しちゃダメよ！\nわたしも！この{r[しま]}島{/r}のスシガミも！
Player_StgWin_C_018_f	だったらみんなでネタをだっこする\nマネをやってみましょ♪
Player_StgWin_C_019_f	スシが{r[す]}好{/r}きならみんな{r[ともだち]}友達{/r}よ♪\n{r[みち]}未知{/r}のスシガミでも{r[かんけい]}関係{/r}ないわ♪
Player_StgWin_C_020_f	{r[ひがん]}悲願{/r}？{r[ゆめ]}夢{/r}の{r[けいかく]}計画{/r}？\n{r[ていこく]}帝国{/r}はなにをするつもりなの？
Player_StgWin_C_021_f	この{r[しま]}島{/r}のスシガミたちも、わたしも\nスシを{r[あい]}愛{/r}しているんだから{r[とうぜん]}当然{/r}よ♪
Player_StgWin_C_022_f	ネタはだっこしたいけど\nこの{r[しま]}島{/r}からは{r[で]}出{/r}たくないって♪
Player_StgWin_C_023_f	おんぶしたらネタが{r[み]}見{/r}えないから\nつらくてもだっこするんだって♪
Player_StgWin_C_024_f	スシネタへの{r[あい]}愛{/r}がおさえきれなくて\nずっと{r[いっしょ]}一緒{/r}にいたいんだって♪
Player_StgWin_C_025_f	ふふっ♪どうかしら？\nやったわね、スシガミたち！
Player_VsWin_Closely	{r[ま]}負{/r}けるかとハラハラしたぜ…。\nまたスシバトルしような！！
Player_VsWin	へへっ、これがオレの\nザ・ウェイ・オブ・スシドーだ♪
Player_VsLose_Closely	くそぉ…あと{r[いっぽ]}一歩{/r}だったのに…！\n{r[つぎ]}次{/r}は{r[ま]}負{/r}けないからなッ！！
Player_VsLose	ちぇ～…{r[こんかい]}今回{/r}はオレの{r[ま]}負{/r}けだな……\n{r[つぎ]}次{/r}はあんたのスシ{r[すじ]}筋{/r}を{r[みき]}見切{/r}るぜ！
Player_VsWin_Closely_f	{r[ま]}負{/r}けるかとハラハラしたわ…。\nまたスシバトルしましょうね！！
Player_VsWin_f	ふふっ、これがわたしの\nザ・ウェイ・オブ・スシドーよ♪
Player_VsLose_Closely_f	んもぉ…あと{r[いっぽ]}一歩{/r}だったのに…！\n{r[つぎ]}次{/r}は{r[ま]}負{/r}けないからねッ！！
Player_VsLose_f	ちぇ～…{r[こんかい]}今回{/r}はわたしの{r[ま]}負{/r}けね……\n{r[つぎ]}次{/r}はあなたのスシ{r[すじ]}筋{/r}を{r[みき]}見切{/r}るわ！
TxtPuzzleTowerModeName	パズルバトル
TxtPuzzleTowerBattledNum	%d戦目
Text_Stage	ステージ
TxtPuzzleThisTimeRecord	今回のきろく
TxtPuzzleModeInfo	{r[かくいろ]}各色{/r}の{r[さら]}皿{/r}を{r[ひとふで]}一筆{/r}でつなぎ、\n{r[じかんない]}時間内{/r}にたおせ！
TxtPuzzleResultFailed	失敗
TxtPuzzleResult_zero	0勝
TxtPuzzleResultSuccess_sg	%d勝
TxtPuzzleResultSuccess_pl	%d勝
Text_End	終了
TxtPuzzleSettlementSerifEnemy00	{r[ざんねん]}残念{/r}でシタ！\nまた{r[ちょうせん]}挑戦{/r}してくだサイ！
TxtPuzzleSettlementSerifEnemy01	まだまだスタート{r[ちてん]}地点{/r}デス！\nパズルバトルは{r[おく]}奥{/r}が{r[ふか]}深{/r}いですヨ！
TxtPuzzleSettlementSerifEnemy02	グッド！ イイ{r[かん]}感{/r}じでしたネ！\nコツをつかんできましたカ？
TxtPuzzleSettlementSerifEnemy03	グレート！ {r[てな]}手慣{/r}れてきましたネ！\nさらに{r[うえ]}上{/r}を{r[めざ]}目指{/r}してみまショウ！
TxtPuzzleSettlementSerifEnemy04	ブラボー！ なかなかの{r[せいせき]}成績{/r}デス！\nでもあなたならもっとできるハズ!!
TxtPuzzleSettlementSerifEnemy05	ベリーグッド！ {r[の]}飲{/r}み{r[こ]}込{/r}みが{r[はや]}早{/r}イ!!\nパズルが{r[くせ]}癖{/r}になってきたでショウ？
TxtPuzzleSettlementSerifEnemy06	エクセレント！ すばらシイ!!\nアメイジングなスシさばきでしタ!!
TxtPuzzleSettlementSerifEnemy07	ワンダフル！ {r[ぜっこうちょう]}絶好調{/r}デスネ!!\nまさしく{r[ずのうは]}頭脳派{/r}スシライカー!!
TxtPuzzleSettlementSerifEnemy08	マーベラス！ ほれぼれシマス!!\nパズルを{r[と]}解{/r}く{r[すがた]}姿{/r}がとても{r[うつく]}美{/r}シイ!!
TxtPuzzleSettlementSerifEnemy09	ファンタスティック！ おミゴト!!\nパズルも{r[きわ]}極{/r}めちゃうんデスカ!?
TxtPuzzleSettlementSerifEnemy10	クレイジー！ {r[い]}言{/r}うことナシ!!\nパズルバトル {r[めんきょかいでん]}免許皆伝{/r}デス!!
TxtPuzzleSettlementSerifPlayer00	くっそお～… スシでパズル…\n{r[あせ]}焦{/r}って{r[あたま]}頭{/r}が{r[こんらん]}混乱{/r}するぜ……
TxtPuzzleSettlementSerifPlayer01	う～ん、なかなか{r[むずか]}難{/r}しいぜ…\nパズルのコツをつかまないとだな
TxtPuzzleSettlementSerifPlayer02	なんとなくわかってきたぞ！\nよ～し、もう１{r[かいちょうせん]}回挑戦{/r}させてくれ!!
TxtPuzzleSettlementSerifPlayer03	ふ～、いい{r[かん]}感{/r}じだったぜ♪\n{r[つぎ]}次{/r}はもっとうまくできる{r[き]}気{/r}がする!!
TxtPuzzleSettlementSerifPlayer04	どんなもんだい♪\nえ…？ まだまだ{r[さき]}先{/r}があるの？
TxtPuzzleSettlementSerifPlayer05	パズルを{r[と]}解{/r}けた{r[とき]}時{/r}の{r[かいかん]}快感{/r}が\nなんだか{r[くせ]}癖{/r}になってきたぜ…!!
TxtPuzzleSettlementSerifPlayer06	へへ～ん♪ パズルバトルでも\nスシセンスがかくしきれないぜ♪
TxtPuzzleSettlementSerifPlayer07	スシライカーは{r[あたま]}頭{/r}のキレも{r[だいじ]}大事{/r}さ♪\nもっともっと{r[うえ]}上{/r}を{r[めざ]}目指{/r}しちゃうぜ!!
TxtPuzzleSettlementSerifPlayer08	すばやくパズルを{r[と]}解{/r}くには{r[うつく]}美{/r}しい\nフォームも{r[ひつよう]}必要{/r}だと{r[き]}気{/r}づいたぜ♪
TxtPuzzleSettlementSerifPlayer09	パズルも{r[きわ]}極{/r}めちゃうんデス♪\n{r[いただき]}頂{/r}までもうちょっとだぜ!!
TxtPuzzleSettlementSerifPlayer10	おっしゃー!!\nパズルバトル {r[きわ]}極{/r}めてやったぜ!!
TxtPuzzleSettlementSerifPlayer00_f	うう～ん… スシでパズル…\n{r[あせ]}焦{/r}って{r[あたま]}頭{/r}が{r[こんらん]}混乱{/r}するわ……
TxtPuzzleSettlementSerifPlayer01_f	う～ん、なかなか{r[むずか]}難{/r}しいわ…\nパズルのコツをつかまないと
TxtPuzzleSettlementSerifPlayer02_f	なんとなくわかってきたわ！\nよ～し、もう１{r[かいちょうせん]}回挑戦{/r}させて!!
TxtPuzzleSettlementSerifPlayer03_f	ふ～、いい{r[かん]}感{/r}じだったわ♪\n{r[つぎ]}次{/r}はもっとうまくできる{r[き]}気{/r}がする!!
TxtPuzzleSettlementSerifPlayer04_f	どんなもんよ♪\nえ…？ まだまだ{r[さき]}先{/r}があるの？
TxtPuzzleSettlementSerifPlayer05_f	パズルを{r[と]}解{/r}けた{r[とき]}時{/r}の{r[かいかん]}快感{/r}が\nなんだか{r[くせ]}癖{/r}になってきたわ…!!
TxtPuzzleSettlementSerifPlayer06_f	ふふ～ん♪ パズルバトルでも\nスシセンスがかくしきれないわ♪
TxtPuzzleSettlementSerifPlayer07_f	スシライカーは{r[あたま]}頭{/r}のキレも{r[だいじ]}大事{/r}よ♪\nもっともっと{r[うえ]}上{/r}を{r[めざ]}目指{/r}しちゃうわ!!
TxtPuzzleSettlementSerifPlayer08_f	すばやくパズルを{r[と]}解{/r}くには{r[うつく]}美{/r}しい\nフォームも{r[ひつよう]}必要{/r}だと{r[き]}気{/r}づいたの♪
TxtPuzzleSettlementSerifPlayer09_f	パズルも{r[きわ]}極{/r}めちゃうんデス♪\n{r[いただき]}頂{/r}までもうちょっとだわ!!
TxtPuzzleSettlementSerifPlayer10_f	やったー!!\nパズルバトル {r[きわ]}極{/r}めちゃったわ!!
